hoimalnad_kannada_1	ಅಜ್ಜಿಯ ಸೀರೆ ಮಡಚೋಕೆ ಆಗಲ್ಲ, ಅಜ್ಜನ ರೊಕ್ಕ ಎಣಿಸೋಕೆ ಆಗಲ್ಲ	ಮೋಡ, ನಕ್ಷತ್ರ
hoimalnad_kannada_2	ಗಿರಗಿರ ತಿರುಗುತ್ತೆ, ಸುಸ್ತಾಗಿ ಬೀಳುತ್ತೆ	ಬುಗುರಿ
hoimalnad_kannada_3	ಹುಟ್ಟುತ್ತಲೇ ಹುಡುಗ ತಲೆಯಲ್ಲಿ ಟೋಪಿ ಹಾಕಿರುತ್ತೆ.	ಬದನೇಕಾಯಿ
hoimalnad_kannada_4	ಸಾಗರ ಪುತ್ರ, ಸಾರಿನ ಮಿತ್ರ	ಉಪ್ಪು
hoimalnad_kannada_5	ಗುಡುಗು, ಗುಡುಗಿದರೆ ಸಾವಿರ ನಯನಗಳು ಅರಳುವುದು	ನವಿಲು
hoimalnad_kannada_6	ಲಟಪಟ ಲೇಡಿಗೆ ಒಂದೇ ಕಣ್ಣು	ಸೂಜಿ
hoimalnad_kannada_7	ಹಸಿರು ಕೋಲಿಗೆ ಮುತ್ತಿನ ತುರಾಯಿ	ಜೋಳದ ತೆನೆ
hoimalnad_kannada_8	ಕಡ್ಲೆ ಕಾಳಷ್ಟು ಹಿಂಡಿ 32 ಮನೆ ಸಾರಿಸಿ ಬಚ್ಚಲ ಪಾಲು ಆಗುತ್ತೆ	ಹಲ್ಲುಪುಡಿ
hoimalnad_kannada_9	ಕೆಂಪು ಕುದುರೆ ಮೇಲೆ ಒಬ್ಬ ಏರುತ್ತಾನೆ, ಒಬ್ಬ ಇಳಿಯುತ್ತಾನೆ	ರೊಟ್ಟಿ, ದೋಸೆ
hoimalnad_kannada_10	ಕರಿ ಗುಡ್ಡಬಿಳಿ ನೀರು ಅದ್ರಾಗೆ ಕುಂತವಳೇ ಚಂಪರಾಣಿ	ಗಡಿಗೆ ಮಜ್ಜಿಗೆ
hoimalnad_kannada_11	ಅಗಲವಾದ ಮಾಳಿಗೆಗೆ ಒಂದೇ ಕಂಬ	ಛತ್ರಿ
hoimalnad_kannada_12	ಬಿಳಿ ತೊಟ್ಟಿಯಲ್ಲಿ ಕಪ್ಪು ದ್ರಾಕ್ಷಿ	ಕಣ್ಣು
hoimalnad_kannada_13	ಎರಡು ಗವಿಗಳಿಗೆ ಒಂದೇ ಗೋಡೆ	ಮೂಗು
hoimalnad_kannada_14	ಹಸಿರು ಮರದಲ್ಲಿ ಮೊಸರು ಚೆಲ್ಲಿದೆ	ಮಲ್ಲಿಗೆ
hoimalnad_kannada_15	ಐದು ಮನೆಗೆ ಒಂದೇ ಅಂಗಳ	ಅಂಗ್ಯ
hoimalnad_kannada_16	ಚಿಕ್ಕ ಮನೆಗೆ ಚಿನ್ನದ ಬೀಗ	ಮೂಗುತಿ
hoimalnad_kannada_17	ಹಗ್ಗ ಹಾಸಿದೆ, ಹಸು ಮಲಗಿದೆ	ಕುಂಬಳಕಾಯಿ
hoimalnad_kannada_18	ಹತ್ತಾರು ಮಕ್ಕಳ ತಂದೆ ಅದಕ್ಕೆ ತಲೆಯ ಮೇಲೆ ಜುಟ್ಟು	ಹುಂಜ
hoimalnad_kannada_19	ಕಿರೀಟ ಇದೆ ರಾಜ ಅಲ್ಲ, ಕಲ ತಿಳಿಸುತ್ತೆ ಗಡಿಯಾರವಲ್ಲ	ಕೋಳಿ
hoimalnad_kannada_20	ಒಂದು ಹಣ್ಣಿಗೆ ಹನ್ನೆರಡು ತೊಳೆ ಮತ್ತೂ ಮೂವತ್ತು ಬೀಜ	ವರ್ಷ
hoimalnad_kannada_21	ಗುಂಡಾಕಾರ ಮೈಯೆಲ್ಲಾ ತೂತು	ದೋಸೆ
hoimalnad_kannada_22	ಬಂಗಾರದ ಗುಬ್ಬಿ ಬಾಲದಲ್ಲೇ ನೀರನ್ನು ಕುಡಿಯುತ್ತೆ	ಚಿಮಿಣಿ
hoimalnad_kannada_23	ಒಂದು ಮರ, ಮರದಾಗ ಅಲ್ಲ, ಅಲ್ಲಿನಾಗ ಕೊಬ್ರಿ ಗುಂಡ	ಆಕಾಶ ನಕ್ಷತ್ರ ಚಂದ್ರ
hoimalnad_kannada_24	ಅನ್ನ ಮಾಡಲಿಕ್ಕೆ ಬಾರದಂತಹ ಅಕ್ಕಿ ಯಾವುದು	ಏಲಕ್ಕಿ
hoimalnad_kannada_25	ಬೆಳ್ಳಿ ಬಟ್ಟಲಲ್ಲಿ ಮುತ್ತಿನ ಬಿಂದು	ತಾರೆ
hoimalnad_kannada_26	ಲಟಪಟ ಲೇಡಿಗೆ ಒಂದೇ ಕಣ್ಣು	ಸೂಜಿ
hoimalnad_kannada_27	ಹಸಿರು ಕೋಲಿಗೆ ಮುತ್ತಿನ ತುರಾಯಿ	ಜೋಳದ ತೆನೆ
hoimalnad_kannada_28	ಬಿಳಿ ಹುಲ್ಲಲ್ಲಿ ಕೆಂಪು ಕುರಿಮರಿ	ನಾಲಿಗೆ
hoimalnad_kannada_29	ಸೂಜಿ ಸಣ್ಣಕಾಗೆ ಬಣ್ಣ	ಕೂದಲು
hoimalnad_kannada_30	ಹೋದರು ಇರುತ್ತೆ ಬಂದರೂ ಕಾಡುತ್ತೆ. ಇದು ಏನು	ನೆನಪು
hoimalnad_kannada_31	ನೀಲಿ ಸಾಗರದಲ್ಲಿ ಬೆಳ್ಳನೇ ಮೀನುಗಳು ನಾನ್ಯಾರು	ತಾರೆಗಳು
hoimalnad_kannada_32	ಬಿಡಿಸಿದರೆ ಹೂವು, ಮಡಚಿದರೆ ಮೊಗ್ಗು	ಛತ್ರಿ
hoimalnad_kannada_33	ಕೂಗಿದರೆ ರಾವಣ, ಹಾರಿದರೆ ಹನುಮಂತ, ಕೂತರೆ ಮುಸಿ	ಕಪ್ಪೆ
hoimalnad_kannada_34	ಮುಳ್ಳುಗಳಿವೆ ಅಪಾಯವಿಲ್ಲ, ಸಂಖ್ಯೆಗಳಿವೆ ಲೆಕ್ಕದ ಪುಸ್ತಕವಲ್ಲ, ಗಂಟೆ ಹೊಡೆಯುತ್ತದೆ, ದೇವಾಲಯವಲ್ಲ.	ಗಡಿಯಾರ
hoimalnad_kannada_35	ಕಾಸಿನ ಕುದುರೆಗೆ ಬಾಲದ ಲಗಾಮು	ಸೂಜಿ ದಾರ
hoimalnad_kannada_36	ಎಲೆ ಇಲ್ಲ, ಸುಣ್ಣ ಇಲ್ಲ, ಬಣ್ಣವಿಲ್ಲ ತುಟಿ ಕೆಂಪಗಾಗಿದೆ, ಮಳೆಯಿಲ್ಲ, ಬೆಲೆಯಿಲ್ಲ, ಮೈ ಹಸಿರಾಗಿದೆ	ಗಿಳಿ
hoimalnad_kannada_37	ಮನೆ, ಮನೆಗೆರಡು ಬಾಗಿಲು, ಬಾಗಿಲ ಮುಂದೆ, ಮುಚ್ಚಿದರೆ ಹಾನಿ ಇದೇನು?	ಮೂಗು, ಬಾಯಿ
hoimalnad_kannada_38	ಸುತ್ತ ಮುತ್ತ ಸುಣ್ಣದ ಗೋಡೆ, ಎತ್ತ ನೋಡಿದರೂ ಬಾಗಿಲಿಲ್ಲ ಇದು ಏನು ?	ಮೊಟ್ಟೆ
hoimalnad_kannada_39	ಅಂಗಳದಲ್ಲಿ ಹುಟ್ಟುವುದು, ಅಂಗಳದಲ್ಲಿ ಬೆಳೆಯುವುದು, ತನ್ನ ಮಕ್ಕಳ ಹಂಗಿಸಿ ಮಾತಾಡುವುದು ಇದು ಏನು?	ಕೋಳಿ
hoimalnad_kannada_40	ಇದ್ದಲು ನುಂಗುತ್ತ, ಗದ್ದಲ ಮಾಡುತ್ತಾ, ಉದ್ದಕ್ಕೂ ಓಡುತ್ತಾ ಮುಂದಕ್ಕೆ ಸಾಗುವ ನಾನ್ಯಾರು?	ರೈಲು
hoimalnad_kannada_41	ಊಟಕ್ಕೆ ಕುಳಿತವರು ಹನ್ನೆರಡು ಜನರು, ಬಡಿಸುವವರು ಇಬ್ಬರು, ಒಬ್ಬನು ಒಬ್ಬರಿಗೆ ಬಡಿಸುವಸ್ಟರಲ್ಲಿ ಇನ್ನೊಬ್ಬನು ಹನ್ನೆರಡು ಜನಕ್ಕೂ ಬಡಿಸಿರುತ್ತಾನೆ	ಗಡಿಯಾರ
hoimalnad_kannada_42	ಹಸಿರು ಹಾವರಾಣಿ, ತುಂಬಿದ ತತ್ರಾಣಿ, ಹೇಳದಿದ್ದರೆ ನಿಮ್ಮ ದೇವರಾಣಿ	ಕಲ್ಲಂಗಡಿ ಹಣ್ಣು
hoimalnad_kannada_43	೧೩.ಒಂದು ರುಮಾಲು ನಮ್ಮಪ್ಪನೂ ಸುತ್ತಲಾರ.	ದಾರಿ
hoimalnad_kannada_44	ಅಬ್ಬಬ್ಬ ಹಬ್ಬ ಬಂತು, ಸಿಹಿಕಹಿ ಎರಡೂ ತಂತು.	ಯುಗಾದಿ
hoimalnad_kannada_45	ಹುಟ್ಟುತ್ತಲೇ ಹುಡುಗ ತಲೆಯಲ್ಲಿ ಟೋಪಿ ಹಾಕಿರುತ್ತೆ.	ಬದನೆಕಾಯಿ.
hoimalnad_kannada_46	ಸಾಗರ ಪುತ್ರ, ಸಾರಿನ ಮಿತ್ರ.	ಉಪ್ಪು
hoimalnad_kannada_47	ಸಾವಿರಾರು ಹಕ್ಕಿಗಳು, ಒಂದೇ ಬಾರಿಗೆ ನೀರಿಗಿಳಿತವೆ.	ಅಕ್ಕಿ
hoimalnad_kannada_48	ಗುಡುಗು, ಗುಡುಗಿದರೆ ಸಾವಿರ ನಯನಗಳು ಅರಳುವುದು.	ನವಿಲು.
hoimalnad_kannada_49	ಕಣ್ಣಿಲ್ಲ, ಕಾಲಿಲ್ಲ,ಆದರು ಚಲಿಸುತಿದೆ ಯಾವುದು ಎಲ್ಲಿದೆ ಬಲ್ಲಿದನ ಹೇಳಿರಲ.	ನದಿ
hoimalnad_kannada_50	ಹಲ್ಲಿಲ್ಲದ ಹಕ್ಕಿಗೆ ಗೂಡು ತುಂಬ ಮರಿಗಳು.	ಕೋಳಿ
hoimalnad_kannada_51	೨೧. ಮೋಟು ಗೋಡೆ ಮೇಲೆ, ದೀಪ ಉರೀತಿದೆ.	ಮೂಗುಬೊಟ್ಟು
hoimalnad_kannada_52	ಹೊಂಚು ಹಾಕಿದ ದೆವ್ವ, ಬೇಡ ಬೇಡ ಎಂದರೂ ಜೂತೆಯೇ ಬರುತ್ತೆ.	ನೆರಳು
hoimalnad_kannada_53	ಮರನು ಮರನೇರಿ ಮತ್ತೆ ಮರನೇರಿ ಬಸವನಾ ಕತ್ತೇರಿ ತಿರುಗುತ್ತಿದೆ	ಗಾಣ
hoimalnad_kannada_54	ಹೊಕ್ಕಿದ್ದು ಒಂದಾಗಿ ಹೊರಟಿದ್ದು ಅದು ನೂರಾಗಿ	ಶ್ಯಾವಿಗೆ
hoimalnad_kannada_55	ಮಣ್ಣು ಆಗಿದೆ ಕಲ್ಲು ಸಿಕ್ಕಿತು, ಕಲ್ಲು ಆಗಿದೆ ಬೆಳ್ಳಿ ಸಿಕ್ಕಿತು, ಬೆಳ್ಳಿ ಒಡೆದ ನೀರು ಸಿಕ್ಕಿತು	ತೆಂಗಿನಕಾಯಿ
hoimalnad_kannada_56	ಕತ್ತಲೆ ಮನೆಯಲಿ ಕಾಳವ್ವ ಕುಂತವೈ ಕುಯ್ಯೋ, ಮರ್ರೋ ಅಂತವಳೇ	ತಂಬೂರಿ
hoimalnad_kannada_57	ಹಾರಿದರೆ ಹನುಮಂತ, ಕೂತರೆ ಮುನಿ, ಕೂಗಿದರೆ ಕಾಡಿನ ಒಡೆಯ	ಕಪ್ಪೆ
hoimalnad_kannada_58	ಕೈಲಿದ್ದಾಗ ಗುದಿಸಾಡುತ್ತೇನೆ, ಕೈ ಬಿಟ್ಟಾಗ ಗೊರಕೆ ಒಡೆಯುತ್ತೇನೆ	ಕಸಪೊರಕೆ
hoimalnad_kannada_59	ಗಿಡ ಕೊಡಲಾರದು, ಮರ ಬೆಳೆಸಲಾರದು ಅದಿಲ್ಲದೆ ಊಟ ಸೇರಲಾರದು	ಉಪ್ಪು
hoimalnad_kannada_60	ಅಕ್ಕ ಪಕ್ಕ ಚದುರಂಗ,ಅದರ ಹೂವು ಪದುರಂಗ ಅದರ ಹೆಸರು ಅಯ್ಯಯ್ಯಪ್ಪ ಇದು ಏನು?	ದತ್ತುರಿಯ ಮುಳ್ಳು.
hoimalnad_kannada_61	ವನದಲ್ಲಿ ಹುಟ್ಟಿ,ವನದಲ್ಲಿ ಬೆಳೆದು,ವನದಿಂದ ಹೊರಟು ವನಜಲೊನೆ ಶಿರಕ್ಕೆರುವರು.	ಕಮಲ.
hoimalnad_kannada_62	ಕೋಳಿ ಕುಗುತ್ತದೆ, ಮುಲ್ಲ ಚೂರಿ ಹಾಕುತ್ತಾನೆ.	ಗಿರಣಿ
hoimalnad_kannada_63	ಸಾವಿರ ತರುತ್ತೆ ಲಕ್ಷ ತರುತ್ತೆ ನೀರಿನಲ್ಲಿ ಹಾಕಿದರೆ ಸಾಯುತ್ತೆ.	ದುಡ್ಡು.
hoimalnad_kannada_64	ತಕ್ಕಡೀಲಿ ಇಟ್ಟು ಮಾರೋ ಹಾಗಿಲ್ಲ, ಅದಿಲ್ಲದೆ ಹಬ್ಬ ಅಗೋ ಹಾಗಿಲ್ಲ.	ಸಗಣಿ.
hoimalnad_kannada_65	ಚರಚರ ಕೊಯ್ತದೆ ಕತ್ತಿ ಅಲ್ಲ, ಮಿಣಿಮಿಣಿ ಮಿಂಚುತ್ತದೆ ಮಿಂಚಲ್ಲ, ಪೆಟ್ಟಿಗೆಗೆ ತುಂಬದೆ ದಾಗಿನ ಅಲ್ಲ.	ಗರಗಸ.
hoimalnad_kannada_66	ಕಡ್ಲೆ ಕಾಳಷ್ಟು ಹಿಂಡಿ೩೨ ಮನೆ ಸಾರಿಸಿ ಬಚ್ಚಲ ಪಾಲು ಆಗುತ್ತೆ.	ಹಲ್ಲುಪುಡಿ.
hoimalnad_kannada_67	ಕರಿ ಗುಡ್ಡ-ಬಿಳಿ ನೀರು ಅದ್ರಾಗೆ ಕುಂತವಳೇ ಚಂಪರಾಣಿ.	ಗಡಿಗೆಮಜ್ಜಿಗೆ.
hoimalnad_kannada_68	೪೬. ಕೆಂಪು ಕುದುರೆ ಮೇಲೆ ಒಬ್ಬ ಏರುತ್ತಾನೆ, ಒಬ್ಬ ಇಳಿಯುತ್ತಾನೆ.	ರೊಟ್ಟಿ, ದೋಸೆ
hoimalnad_kannada_69	ಕೆಂದ ಕುದುರೆ,ಬಿಳಿ ತಡಿ, ಕರೆ ಲಗಾಮು, ಅಣ್ಣ ಅತ್ತಾನೆ, ತಮ್ಮ ಇಳಿತ್ತಾನೆ	ಬೆಂಕಿ, ಸುಣ್ಣ ಹಚ್ಚಿದ ಹಂಚು, ಹೊಗೆ, ರೊಟ್ಟಿ
hoimalnad_kannada_70	ಕಂಬ ಕಂಬದ ಮೇಲೆ ದಿಂಬ, ದಿಂಬದ ಮೇಲೆ ಲಾಗಲೂಟೆ, ಲಾಗಲೂಟೆ ಮೇಲೆ ಎರಡು ಹುಡ್ಗರು ಓಡ್ಯಾಡುತಾರೆ.	ಕಣ್ಣು.
hoimalnad_kannada_71	ಶತ್ತಗಿಂಡಿ, ಶಾರಾಗಿಂಡಿ, ನೀರಾಗಿ ಹಕ್ಕಿದರೆ ಮುಳುಗದು ಮುತ್ತಿನ ಗಿಂಡಿ.	ಬೆಣ್ಣೆ ಉಂಡೆ.
hoimalnad_kannada_72	ಕುತ್ತಿಗೆ ಇದೆ ತಲೆ ಇಲ್ಲ, ತೋಳಿದೆ ಬೆರಳಿಲ್ಲ, ದಡಾ ಇದೆ, ಕಾಲಿಲ್ಲ.	ಅಂಗಿ.
hoimalnad_kannada_73	ಹಸಿರು ಗಿಡದ ಮೇಲೆ ಮೊಸರು ಚೆಲ್ಲಿದೆ	ಮಲ್ಲಿಗೆ
hoimalnad_kannada_74	ಅಂಗೈ ಅಗಲದ ರೊಟ್ಟಿಗೆ ಲೆಕ್ಕವಿಲ್ಲದಷ್ಟು ಉಪ್ಪಿನಕಾಯಿ	ಆಕಾಶ, ನಕ್ಷತ್ರ
hoimalnad_kannada_75	ಸುಟ್ಟ ಹೆಣ ಮತ್ತೆ ಸುಡ್ತಾರೆ	ಇದ್ದಿಲು
hoimalnad_kannada_76	ಚಿನ್ನದ ಪೆಟ್ಟಿಗೆಯಲ್ಲಿ ಬೆಳ್ಳಿ ಲಿಂಗ	ಬಾಳೆ ಹಣ್ಣು
hoimalnad_kannada_77	ಅಂಗೈ ಕೊಟ್ಟರೆ ಮುಂಗೈನೂ ನುಂಗುತ್ತದೆ	ಬಳೆ
hoimalnad_kannada_78	ಅಂಗೈ ಕೊಟ್ಟರೆ ಮುಂಗೈನೂ ನುಂಗುತ್ತದೆ	ಬಳೆ
hoimalnad_kannada_79	ಒಂದು ಹಪ್ಪಳ ಊರಿಗೆಲ್ಲ ಊಟ	ಚಂದ್ರ
hoimalnad_kannada_80	ಆಕಾಶದಲ್ಲಿ ಕೊಡಲಿಗಳು ತೇಲಾಡುತ್ತವೆ	ಹುಣಸೇಹಣ್ಣು
hoimalnad_kannada_81	ನೀಲಿ ಕೆರೆಯಲಿ ಬಿಳಿ ಮೀನು	ನಕ್ಷತ್ರ
hoimalnad_kannada_82	ಒಂದು ತೇಲುತ್ತೆ ,ಒಂದು ಮುಳುಗುತ್ತೆ, ಒಂದು ಕರಗುತ್ತೆ.	ವಾರ,ತಿಂಗಳು,ವರ್ಷ
hoimalnad_kannada_83	ಬಾ ಅಂದರೆ ಬರೋಲ್ಲ, ಹೋಗು ಅಂದರೆ ಹೋಗೋಲ್ಲ	ಮಳೆ
hoimalnad_kannada_84	ನಾ ಇರುವಾಗ ಬರುತ್ತೆ, ನಾ ಹೋದ ಮೇಲೂ ಇರುತ್ತೆ	ಕೀರ್ತಿ
hoimalnad_kannada_85	ಬೆಳ್ಳಿ ಸಮುದ್ರದಲ್ಲಿ ಕಪ್ಪು ಸೂರ್ಯ	ಕಣ್ಣು
hoimalnad_kannada_86	ಅಕ್ಕನ ಮೇಲೆ ಛತ್ರಿ	ರೆಪ್ಪೆ
hoimalnad_kannada_87	ತಮ್ಮಂಗೆ ಮೂರು ಕಣ್ಣು ಅಮ್ಮಂಗೆ ಒಂದೇ ಕಣ್ಣು	ತೆಂಗಿನ ಕಾಯಿ
hoimalnad_kannada_88	ಅಕ್ಕ ಓದುತ್ತಾಳೆ ತಂಗಿ ನಡೀತ್ತಾಳೆ	ಕಣ್ಣು
hoimalnad_kannada_89	ಅಮ್ಮನ ಆಕಾಶವಾಣಿ ನಾನು	ಮಗು
hoimalnad_kannada_90	ಅಂಗಡಿಯಿಂದ ತರೋದು ಮುಂದಿಟ್ಟುಕೊಂಡು ಅಳೋದು	ಈರುಳ್ಳಿ
hoimalnad_kannada_91	ಅಂಗಣ್ಣ ಮಂಗಣ್ಣ ಅಂಗಿ ಬಿಚ್ಚಿಕೊಂಡು ನುಂಗಣ್ಣ	ಬಾಳೆಹಣ್ಣು
hoimalnad_kannada_92	ಗೂಡ್ನಲ್ಲಿರೋ ಜೋಡಿ ಪಕ್ಷಿ ಊರೆಲ್ಲ ನೋಡುತ್ತೆ	ಕಣ್ಣು
hoimalnad_kannada_93	ಒಂದು ಮಡಕೆ, ಮಡಕೆಯೊಳಗೆ, ಕುಡಿಕೆ, ಕುಡಿಕೆಯಲ್ಲಿ ಸಾಗರ	ತೆಂಗಿನ ಕಾಯಿ
hoimalnad_kannada_94	ನೀನಿಲ್ಲದೆ ಊಟವಿಲ್ಲ	ಉಪ್ಪು
hoimalnad_kannada_95	ಬಿಳಿ ಸರದಾರನಿಗೆ ಕರಿ ಟೋಪಿ	ಬೆಂಕಿಕಡ್ಡಿ
hoimalnad_kannada_96	ಕಾಲಿಲ್ಲ ಹುಡುಗಿಗೆ ಮಾರುದ್ದ ಕಡಿವಾಣ	ಸೂಜಿ
hoimalnad_kannada_97	ಮೂರು ಕಾಸಿನ ಕುದುರೆಗೆ ಮುನ್ನೂರು ರೂಪಾಯಿನ ಹಗ್ಗ	ಹೇನು ಕೂದಲು
hoimalnad_kannada_98	ಕೆಂಪು ಕುದುರೆಗೆ ಲಗಾಮು, ಓಬ್ಬ ಹತ್ತುತ್ತಾನೆ, ಇನ್ನೊಬ್ಬ ಇಳಿತಾನೇ	ಬೆಂಕಿ,ಬಾಣಲೆ, ದೋಸೆ
hoimalnad_kannada_99	ಒಂದು ಮನೆಗೆ ಒಂದೇ ತೊಲೆ	ತಲೆ
hoimalnad_kannada_100	ಕಂದ ಬಂದ ಕೊಂದ ತಂದ	ಶ್ರೀ ರಾಮ ಚಂದ್ರ
hoimalnad_kannada_101	ಕಲ್ಲಿಲ್ಲದ ಬೆಟ್ಟ ಮರಳಿಲ್ಲದ ಮರುಭೂಮಿ	ಭೂಪಟ
hoimalnad_kannada_102	ಚಿಕ್ಕಕ್ಕನಿಗೆ ಪುಕ್ಕುದ್ದ	ಸೌಟು
hoimalnad_kannada_103	ಎರಡು ಮನೆಗೆ ಒಂದೇ ದೂಲ	ಮೂಗು
hoimalnad_kannada_104	ನೀರಿರೋತಾವ ನಿಲ್ಲಲೇ ಕೋಣ	ಚಪ್ಪಲಿ
hoimalnad_kannada_105	ಹೋದ ನೆಂಟ, ಬಂದ ದಾರಿ ಗೊತ್ತಿಲ್ಲ	ನೆರಳು
hoimalnad_kannada_106	ಮರದೊಳಗೆ ಮರ ಹುಟ್ಟಿ ಮರ ಚಕ್ರ ಕಾಯಾಗಿ ತಿನ್ನಬಾರದ ಹಣ್ಣು ಬಲು ರುಚಿ	ಮನುಷ್ಯನ ಹುಟ್ಟು ಮಗು
hoimalnad_kannada_107	೮೪. ಕಲ್ಲರಳಿ ಹೂವಾಗಿ, ಎಲ್ಲರಿಗೂ ಬೇಕಾಗಿ, ಮಲ್ಲಿಕಾರ್ಜುನನ ಗುಡಿಗೆ ಬೆಳಕಾಗಿ, ಬಲ್ಲವರು ಹೇಳಿ	ಸುಣ್ಣ
hoimalnad_kannada_108	ಚಿಣಿಮಿನಿ ಎನ್ನುವ ಕೆರೆ, ಚಿಂತಾಮಣಿ ಎನ್ನುವ ಹಕ್ಕಿ, ಕೆರೆ ಬತ್ತಿದರೆ ಹಕ್ಕಿಗೆ ಮರಣ	ದೀಪ
hoimalnad_kannada_109	ಹೋಗುತ್ತಾ, ಬರುತ್ತಾ ಇರುವುದು ಎರಡು,ಹೋದ ಮೇಲೆ ಬರಲಾರವು ಎರಡು	ಸಿರಿತನ-ಬಡತನ, ಪ್ರಾಣ -ಬಡತನ
hoimalnad_kannada_110	ಒಂದು ಹಸ್ತಕ್ಕೆ ನೂರೆಂಟು ಬೆರಳು	ಬಾಳೆಗೊನೆ
hoimalnad_kannada_111	ಎಲ್ಲರ ಮನೆ ಅಜ್ಜಿಗೆ ಮೈಯೆಲ್ಲಾ ಕಜ್ಜಿ	ಜರಡಿ
hoimalnad_kannada_112	ಎಂದರೆ ತೆರಿತಾವ, ಅಪ್ಪ ಎಂದರೆ ಮುಚ್ಚುತಾವ	ಬಾಯಿ
hoimalnad_kannada_113	ದಾಸ್‌ ಬುರುಡೆ ದೌಲಥ ಬುರುಡೆ, ಲೋಕಕ್ಕೆಲ್ಲ ಎರಡೇ ಬುರುಡೆ	ಸೂರ್ಯ, ಚಂದ್ರ
hoimalnad_kannada_114	ಅಪ್ಪ ಆಕಾಶಕ್ಕೆ ಅವ್ವ ಪಾತಾಳಕ್ಕೆ ಮಗ ವ್ಯಾಪಾರಕ್ಕೆ ಮಗಳು ಮದುವೆಗೆ	ಅಡಿಕೆ ಮರ
hoimalnad_kannada_115	ಹಾರಾಡುತ್ತಿದೆ ಗಾಳಿಪತವಲ್ಲ, ಬಣ್ಣ ಮೂರಿರುವುದು ಕಾಮನಬಿಲ್ಲಲ್ಲ	ಧ್ವಜ
hoimalnad_kannada_116	ನೀಲಿ ಸಾಗರದಲ್ಲಿ ಬೆಳ್ಳನೆ ಮೀನುಗಳು ನಾನ್ಯಾರು?	ತಾರೆಗಳು
hoimalnad_kannada_117	ಬಿಡಿಸಿದರೆ ಹೂವು, ಮದಚಿದರೆ ಮೊಗ್ಗು,ಇದು ಏನು?	ಛತ್ರಿ
hoimalnad_kannada_118	ಆರು ಕಾಲು ಅಂಕಣ್ಣ ಮೂರು ಕಾಲು ದೊಂಕಣ್ಣ ಸದಾ ಮೀಸೆ ತಿರುವಣ್ಣ	ನೊಣ
hoimalnad_kannada_119	ಒಂಟಿಕಾಲಿನ ಕುಂಟ. ನಾನ್ಯಾರು?	ಬುಗರಿ
hoimalnad_kannada_120	ಹಲ್ಲು ಹಾಕಿದರೆ ಹಾಲು ಕೆಡೋಲ್ಲ ಕಲ್ಲು ಹಾಕಿದರೆ ಕೆಡುತ್ತೇ	ಕಳ್ಳಿ
hoimalnad_kannada_121	ಕಾಡಿನಲ್ಲಿ ಹುಟ್ಟುವುದು ಕಾಡಿನಲ್ಲಿ ಬೆಳೆಯುವುದು ಕಡಿದಲ್ಲಿ ಕಂಪ ಸೂಸುವೆನು	ಶ್ರೀಗಂಧ
hoimalnad_kannada_122	ಹಸಿರು ಕೋಟೆ, ಬಿಳಿ ಕೋಟೆ, ಕೆಂಪಿನ ಕೋಟೆ ಈ ಕೋಟೆಯೊಳಗೆ ಕಪ್ಪು ಸಿಪಾಯಿಗಳು	ಪರಂಗಿ ಹಣ್ಣು
hoimalnad_kannada_123	ಕೆಂಪು ಕುದುರೆ ಕರಿ ತಡಿ ಒಬ್ಬ ಏರುತಾನೆ ಒಬ್ಬ ಇಳಿತಾನೆ	ರೊಟ್ಟಿ
hoimalnad_kannada_124	ಮೂರೂ ಪಕ್ಷಿಗಳು ಗೂಡಿಗೆ ಹೋಗುವಾಗ ಬೇರೆ ಬೇರೆ ಬಣ್ಣ ಬರುವಾಗ ಬಣ್ಣ	ಎಲೆ ಅದಿಕೆ
hoimalnad_kannada_125	ಆಕಾಶದೊಳಗಿನ ಗಿಣಿ ಊಟದ ಹೊತ್ತಿಗೆ ರಾಣಿ	ಬಾಳೆಲೆ
hoimalnad_kannada_126	ಎರಡು ಬಾವಿಗಳ ನಡುವೆಯೊಂದು ಸೇತುವೆ	ಮೂಗು
hoimalnad_kannada_127	ತಿಂಡಿಗೆ ಕಡಿಮೆ ಇಲ್ಲ, ತೀರ್ಥ ಕುಡಿದರೆ ಸಾವು	ವಿಷ
hoimalnad_kannada_128	ಒಬ್ಬಳು ಮುಲುಗಿದಳು, ಒಬ್ಬಳು ಕರಗಿದಳು, ಒಬ್ಬಳು ತೇಲಿದಳು	ಅಡಿಕೆ, ಸುಣ್ಣ
hoimalnad_kannada_129	ಹೋಗೋದು ಮುಳುಗೋದು ತರೋದು ಏನು?	ಬಿಂದಿಗೆ
hoimalnad_kannada_130	ಹೋದರು ಇರುತ್ತೆ ಬಂದರೂ ಕಾಡುತ್ತೆ.ಇದು ಏನು?	ನೆನಪು
hoimalnad_kannada_131	ಆರು ಕಾಲಿನ ಆನೆ, ಆನೆ ತಿನ್ನುತ್ತೆ ನೀರು ಕುಡಿಯಲ್ಲ	ನುಸಿ
hoimalnad_kannada_132	ಊರಿಗೆಲ್ಲ ಒಂದೇ ಕಂಬಳಿ	ಆಕಾಶ
hoimalnad_kannada_133	ಅಟ್ಟದ ಮೇಲೆ ಪುಟ್ಟ ಲಕ್ಷ್ಮಿ	ಕುಂಕುಮ
hoimalnad_kannada_134	ಕರಿ ಹೊಲದ ಮದ್ಯದಲ್ಲಿ ಬೇಲಿ ದಾರಿ	ಬೈತಲೆ
hoimalnad_kannada_135	ಒಂದು ಬತ್ತಿ ಮನೆಯೆಲ್ಲ ಬೆಳಕು	ಸೂರ್ಯ
hoimalnad_kannada_136	ಕಣ್ಣಿಗೆ ಕಾಣೋದಿಲ್ಲ, ಕೈಗೆ ಸಿಗೋದಿಲ್ಲ	ಗಾಳಿ
hoimalnad_kannada_137	ಕಣ್ಣಿಗೆ ಹತ್ತಿರ ಕಾಲಿಗೆ ದೂರ	ಬೆಟ್ಟ
hoimalnad_kannada_138	ಊಟಕ್ಕೆ ಮೊದಲು ನಾನು ಅಂತ ಬರುತ್ತೆ	ಬಾಳೆ ಎಲೆ, ತಟ್ಟೆ
hoimalnad_kannada_139	ಹಸಿರು ಮೈ ಹಳದಿ ಮೈ ಪೇಟೇಲಿ ಕುಳಿತು ಎಲ್ಲರನ್ನು ಕರೆಯುತ್ತೆ	ಮಾವು
hoimalnad_kannada_140	ಹುಲಿಯ ಚಿಕ್ಕಮ್ಮ, ಇಲಿಯ ಮುಕ್ಕಮ್ಮ	ಬೆಕ್ಕು
hoimalnad_kannada_141	ಕೂಗಿದರೆ ರಾವಣ, ಹಾರಿದರೆ ಹನುಮಂತ, ಕೂತರೆ ಮುನಿ	ಕಪ್ಪೆ
hoimalnad_kannada_142	ಕಾಲಿಲ್ಲದೇ ನಡೆಯುವುದು, ತಲೆ ಎಲ್ಲಡೆ ನುಡಿಯುವುದು, ಮೇಲು ಕೆಳಗಾಗಿ ಓದುವುದು	ನದಿ
hoimalnad_kannada_143	ಜಂಬು ನೇರಳೆ ಮರ, ಎಳೆದರೆ ನಾಲ್ಕು ಬಾವಿ ನೀರು ಒಂದೇ ಆಗುತ್ತದೆ	ಮೇಡು
hoimalnad_kannada_144	ಇಡೀ ಮನೆಗೆಲ್ಲ ಒಂದೇ ಕಂಬಳಿ, ಬಾಯಿ ತೆರೆದರೆ ಮೂಗು ಮುಚ್ಚುತ್ತಿ	ಆಕಾಶ
hoimalnad_kannada_145	ಒಂದು ಕಾಲಿನ ಪಕ್ಷಿಗೆ ಒಂಭತ್ತು ರೆಕ್ಕೆ, ಒಂದೇ ಕಾಲಲಿ ನಿಂತು ನೂರಾರು ಮೊಟ್ಟೆ ಇಡುತ್ತದೆ	ಜೋಳದ ದಂಟು
hoimalnad_kannada_146	ಎತ್ತ ಹೋದರು ಕುತ್ತಿಗೆಗೆ ಕೈ ಹಾಕುತ್ತಾರೆ! ನಾನ್ಯಾರು?	ಸಾಲಿಗ್ರಾಮ
hoimalnad_kannada_147	ಕರಿ ಹುಡುಗನಿಗೆ ಬಿಳಿ ಟೋಪಿ	ಹೆಂಡದ ಮಡಿಕೆ
hoimalnad_kannada_148	ಬಿಳಿ ಆಕಾಶದಲ್ಲಿ ಕಪ್ಪು ನಕ್ಷತ್ರಗಳು, ಇದನ್ನು ನೋಡಲು ಜನ ಕಾದಿಹರು	ನಾಣ್ಯ
hoimalnad_kannada_149	ಗೋಡೆ ಗುದ್ದಪ್ಪ ನೀನಿದ್ದಲ್ಲಿ ನಿದ್ದೆ ಇಲ್ಲಪ್ಪ.	ತಿಗಣೆ
hoimalnad_kannada_150	ಕುದುರೆ ಬಾಲದಿಂದ ನೀರು ಕುಡಿಯುತ್ತದೆ	ಹೇನು
hoimalnad_kannada_151	ಬಿಳಿ ಸಾಮ್ರಾಜ್ಯದಲ್ಲಿ ಕಪ್ಪು ಪ್ರಜೆಗಳು.	ಸೀತ ಫಲ
hoimalnad_kannada_152	ಅಣ್ಣ ಅತ್ತರೆ ತಮ್ಮನೂ ಅಳುತ್ತಾನೆ.	ಕಣ್ಣು
hoimalnad_kannada_153	ಮನೆ ಮೇಲೆ ಮಲ್ಲಿಗೆ ಹೂವು.	ಮಂಜು
hoimalnad_kannada_154	ಹಾರಿದರೆ ಹನುಮಂತ ಕೂಗಿದರೆ ಶಂಖ.	ಕಪ್ಪೆ
hoimalnad_kannada_155	ನೋಡಿದರೆ ಕಲ್ಲು ನೀರು ಹಾಕಿದರೆ ಮಣ್ಣು.	ಸುಣ್ಣ
hoimalnad_kannada_156	ಸುದ್ದಿ ಸೂರಪ್ಪ ದೇಶವೆಲ್ಲಾ ಸುತ್ತಾಡ್ತಾನೆ.	ಪೋಸ್ಟ್ ಕಾರ್ಡ್
hoimalnad_kannada_157	ಬಿಳಿ ಕುದುರೆಗೆ ಹಸಿರು ಬಾಲ.	ಮೂಲಂಗಿ
hoimalnad_kannada_158	ಚಿಕ್ಕ ಬೆಟ್ಟದಲ್ಲಿ ಪುಟ್ಟ ಚಂದ್ರ.	ಕುಂಕುಮ
hoimalnad_kannada_159	ಬರೋದ ಕಂಡು ಕೈ ಒಡ್ತಾರೆ.	ಬಸ್
hoimalnad_kannada_160	ಹತ್ತಾರು ಮಕ್ಕಳ ತಂದೆ ಅದಕ್ಕೆ ತಲೆಯ ಮೇಲೆ ಜುಟ್ಟು	ಹುಂಜ
hoimalnad_kannada_161	ಹಸಿರು ಮುಖಕ್ಕೆ ವಿಪರೀತ ಕೋಪ, ಕೋಪ ಮಾಡಿಕೊಳ್ಳದೆ ನಾನ್ಯಾರೆಂದು ಹೇಳಿ?	ಮೆಣಸಿನಕಾಯಿ
hoimalnad_kannada_162	ಅಜ್ಜಿ ಗುದ್ದಿದರೆ ಮನೆಯೆಲ್ಲ ಮಕ್ಕಳು ಈಗ ಹೇಳಿ ನಾನ್ಯಾರು	ಬೆಳ್ಳುಳ್ಳಿ
hoimalnad_kannada_163	ಹಗಲಲ್ಲಿ ಮಾಯಾ ರಾತ್ರಿಯಲ್ಲಿ ಪ್ರತ್ಯಕ್ಷ ? ನಾನ್ಯಾರು ಹೇಳಿ?	ನಕ್ಷತ್ರ
hoimalnad_kannada_164	ಹಗ್ಗ ಹಾಸಿದೆ ಕೋಣ ಮಲಗಿದೆ	ಕುಂಬಳಕಾಯಿ, ಬಳ್ಳಿ
hoimalnad_kannada_165	ನನ್ನ ಕಂಡರೆ ಎಲ್ಲರು ಓದೀತಾರೆ	ಚೆಂಡು
hoimalnad_kannada_166	ಹಳ್ಳಿ ಗಡಿಯಾರ, ಒಳ್ಳೆ ಆಹಾರ	ಕೋಳಿ
hoimalnad_kannada_167	ನೀರು ಇರುತ್ತೆ ನದಿ ಅಲ್ಲ, ಬಾಗಿಲು ಇರುತ್ತೆ ಮನೆ ಅಲ್ಲ	ಕಣ್ಣು.
hoimalnad_kannada_168	ಬಲಗೈಯಲ್ಲಿ ಗೀತೆ ಎಡಗೈಯಲ್ಲಿ ರಾಟೆ ಹಿಡಿದಿದ್ದೆ ನಾನು ಯಾರು	ಗಾಂಧೀಜಿ
hoimalnad_kannada_169	ಬಾಯಲ್ಲಿ ಹಲ್ಲಿಲ್ಲ, ಮಯಲ್ಲಿ ಶಕ್ತಿ ಇಲ್ಲ, ತಲೆಯಲ್ಲಿ ಕೂದಲಿಲ್ಲ, ಆದ್ರೂ ಎಲ್ಲುನ್ನು ಕಾಡತಿನಿ ನಾನ್ಯಾರು.	ಸೊಳ್ಳೆ
hoimalnad_kannada_170	ಅಕ್ಷರಗಳಿದ್ದರೂ ಪುಸ್ತಕವಲ್ಲ,ಸಿಂಹವಿದ್ದರೂ ಅರಣ್ಯವಲ್ಲ,ದುಂಡಾಗಿದ್ದರೂ ಚಕ್ರವಲ್ಲ,ನಾನ್ಯಾರು.	నాణ్య
hoimalnad_kannada_171	ಗಂಟೆ ಹೊಡೆಯುತ್ತಾನೆ ಪೂಜಾರಿ ಅಲ್ಲ, PAPER ಅರಿಯುತ್ತಾನೆ ಆದರೆ ಹುಚ್ಚುನೂ ಅಲ್ಲ, ಹಣ ಕೇಳುತ್ತಾನೆ ಭಿಕ್ಷುಕ ಅಲ್ಲ	ಕಂಡಕ್ಟರ್
hoimalnad_kannada_172	ಹಿಡಿದರೆ ಹಿಡಿಯಷ್ಟು ಬಿಟ್ಟರೆ ಮನೆತುಂಬ	ದೀಪದ ಬೆಳಕು
hoimalnad_kannada_173	ಕಾಲಿಲ್ಲದೆ ನಡೆಯುವುದು ಬಾಯಿಲ್ಲದೆ ನುಡಿಯುವುದು ಇದರ ಹೊಟ್ಟೆ ಹಲವಕ್ಕೆ ಮನೆಯಾಗಿರುವುದು	ನದಿ
hoimalnad_kannada_174	ಚೋಟುದ್ದ ಹುಡುಗಿಗೆ ಮಾರುದ್ದ ಜಡೆ	ಸೂಜಿ ದಾರ
hoimalnad_kannada_175	ಊರುಂಟು ಜನರಿಲ್ಲ ನದಿಯುಂಟು ನೀರಿಲ್ಲ	ಭೂಪಟ.
hoimalnad_kannada_176	ಚಿಕ್ಕ ಬೋರನಿಗೆ ಬಾಲದಲ್ಲಿ ಕತ್ತಿ	ಹುರಳಿಕಾಯಿ
hoimalnad_kannada_177	ಬಿಳಿಯ ಹೊಲದಲ್ಲಿ ಕರಿ ಕಾಳು ಕೈಯಲ್ಲಿ ಬಿತ್ತುತ್ತಾರೆ ಬಾಯಲ್ಲಿ ಏತ್ತುತ್ತಾರೆ ನಾನು ಯಾರು	ಪುಸ್ತಕ ಮತ್ತು ಅಕ್ಷರಗಳು
hoimalnad_kannada_178	ಮೂರು ಕಡೆ ನೀರು ನೆತ್ತಿ ಮೇಲೆ ಬೆಟ್ಟ ಹಾಗಾದರೆ ನಾನು ಯಾರು?	ಭಾರತ
hoimalnad_kannada_179	ನಾಲ್ಕು ಕಂಬಗಳುಂಟು ದೇವಾಲಯವಲ್ಲ; ಎರಡು ಮೊರಗಳುಂಟು ಕೇರಲಾಗುವುದಿಲ್ಲ; ಒಂದು ಕಹಳೆಯುಂಟು ಊದಲಾಗುವುದಿಲ್ಲ; ಹಾಗಾದರೆ ನಾನು ಯಾರು?	ಆನೆ
hoimalnad_kannada_180	ಕರಿ ಕಂಬ್ಬಿ ನೆಂಟ, ಸರೊತ್ತಿನಲ್ಲಿ ಹೊಂಟ, ಅವನ್ಯಾರು?	ಹೆಗ್ಗಣ
hoimalnad_kannada_181	ರಾಮನಂತ ಸಮುದ್ರ ರತ್ನದಂತ ಮೀನು ನೀರು ಬತ್ತಿಹೋದ್ರೆ ಮೀನು ಸತ್ತು ಹೋಗುತ್ತೆ	ದೀಪ/ಹಣತೆ
honalu_Kannada_1	ಬಿಳಿ ಸಿಪಾಯಿಗೆ ಕರಿಟೋಪಿ	ಬೆಂಕಿಕಡ್ಡಿ
honalu_Kannada_2	ಬಿಳಿ ಸಮುದ್ರದ ಮೇಲೆ ಬೆಳ್ಳಿ ಬೆಟ್ಟ ತೇಲುತ್ತೆ	ಬೆಣ್ಣೆ
honalu_Kannada_3	ಅಂಕುಡೊಂಕಿನ ಮನೆ-ಬಡಗಿ ಕಟ್ಟದ ಮನೆ-ಬಾಚಿ ಮುಟ್ಟದ ಮನೆ	ಹುತ್ತ
honalu_Kannada_4	ನೆತ್ತಿಯಲಿ ಉಂಬುವುದು-ಸುತ್ತಲೂ ಚೆಲ್ಲುವುದು, ಎತ್ತಿದರೆ ಎರಡು ಹೋಳಾಗುವುದು	ರಾಗಿಕಲ್ಲು
honalu_Kannada_5	ಜನರಿಲ್ಲದ ನಾಡು-ಮರವಿಲ್ಲದ ಕಾಡು, ನೀರಿಲ್ಲದ ತೋಡು-ಮೀನಿರದ ಕಡಲು	ಬೂಪಟ
honalu_Kannada_6	ಮೂರು ಬಗೆ ಹಕ್ಕಿ ಒಂದೇ ಗೂಡಿಗೆ ಹೋಗ್ತವೆ, ಬರೋ ಹೊತ್ತಿಗೆ ಒಂದೇ ಬಗೆಯಾಗ್ತವೆ.	ಎಲೆ ಅಡಕೆ ಸುಣ್ಣ
honalu_Kannada_7	ಕಲ್ಲರಳಿ ಹೂವಾಯ್ತು-ಎಲ್ಲರಿಗೂ ಬೆಳಕಾಯ್ತು, ಮಲ್ಲಯ್ಯನ ಶಿಕರಕ್ಕೆ ಬೆಳಕಾಯ್ತು	ಸುಣ್ಣ
honalu_Kannada_8	ಚಿಪ್ಪುಂಟು ಆಮೆಯಲ್ಲ-ಜುಟ್ಟುಂಟು ರಿಸಿಯಲ್ಲ, ಮೂರು ಕಣ್ಣುಗಳುಂಟು ಮುಕ್ಕಣ್ಣನಲ್ಲ	ತೆಂಗಿನಕಾಯಿ
honalu_Kannada_9	ಬಡಗಿ ಮಾಡಿದ ಬಂಡಿಯಲ್ಲ-ಮನುಶ್ಯ ಮಾಡಿದ ಯಂತ್ರವಲ್ಲ, ಒಂದು ನಿಮಿಶವೂ ಪುರುಸೊತ್ತಿಲ್ಲ	ಬೂಮಿ
honalu_Kannada_10	ರಾಜರಾಣಿಯರುಂಟು ರಾಜ್ಯವಲ್ಲ-ಹೂಬಳ್ಳಿಯುಂಟು ತೋಟವಲ್ಲ, ಅಂಕಿ ಅಕ್ಶರಗಳುಂಟು ಪುಸ್ತಕವಲ್ಲ	ಬೆಳ್ಳಿ ರೂಪಾಯಿ
honalu_Kannada_11	ಕಪ್ಪುಂಟು ಕಸ್ತುರಿಯಲ್ಲ-ಬಿಳುಪುಂಟು ಸುಣ್ಣವಲ್ಲ, ನೀರುಂಟು ಬಾವಿಯಲ್ಲ-ರೆಕ್ಕೆಯುಂಟು ಪಕ್ಶಿಯಲ್ಲ	ಕಣ್ಣು
honalu_Kannada_12	ಅಕ್ಕ ಅಕ್ಕ ಬಾವಿ ನೋಡ-ಬಾವಿಯೊಳಗಿನ ನೀರು ನೋಡ, ನೀರಿನೊಳಗಿನ ಬಳ್ಳಿ ನೋಡ, ಬಳ್ಳಿಯೊಳಗಿನ ಹೂವ ನೋಡ	ಎಣ್ಣೆ-ಬತ್ತಿ-ಜ್ಯೋತಿಯಿಂದ ಕೂಡಿದ ದೀಪ
honalu_Kannada_13	ಹಸಿರು ಗಿಡ್ದಾಗ ಮಸರ ಚೆಲ್ಯೇದ	ಹತ್ತಿ
honalu_Kannada_14	ಅಂಬರದಲ್ಲಿ ಆಡುವುದು ಪಕ್ಶಿಯು ತಾನಲ್ಲ, ಕೊಂಬು ಬಾಲಗಳುಂಟು ಮ್ರುಗ ಜಾತಿಯಲ್ಲ, ಬಿಲ್ಲುಬಾಣಗಳುಂಟು ಹೊಡೆಯುವವರು ಇಲ್ಲ ಇದ ಹೇಳಬಲ್ಲ ಜಾಣನಿಗೆ ಅರಿಯದೇ ಇದ್ದಿದ್ದಲ್ಲ	ಗಾಳಿಪಟ
kannadachetana_Kannada_1	ಗಿರಿಗಿರ ತಿರುಗುತ್ತದೆ ಸುಸ್ತಾಗಿ ಬರುತ್ತದೆ.	ಬುಗರಿ
kannadachetana_Kannada_2	ಹಸಿರು ಗಿಡದ ಮೇಲೆ ಮೊಸರು ಚಲ್ಲಿದೆ.	ಮಲ್ಲಿಗೆ ಗಿಡ
kannadachetana_Kannada_3	ಬೆಳ್ಳಿ ಸಮುದ್ರದ ಮೇಲೆ ಕಪ್ಪು ಸೂರ್ಯ.	ಕಣ್ಣು
kannadachetana_Kannada_4	ಅಂಗಡಿಯಿಂದ ತಂದು ಮುಂದಿಟ್ಟುಕೂಂಡು ಅಳೋದು.	ಈರುಳ್ಳಿ
kannadachetana_Kannada_5	ಅಗಲವಾದ ಮಾಳಿಗೆಗೆ ಒಂದೆ ಕಂಬ.	ಛತ್ರಿ
kannadachetana_Kannada_6	ಎರಡು ಬಾವಿಗೆ ನಡುವೆ ಒಂದೆ ಕಣ್ಣು.	ಮೂಗು
kannadachetana_Kannada_7	ಅಪ್ಪನ ದುಡ್ಡು ಎಣಿಸೂಕಾಗಲ್ಲ ಅಮ್ಮನ ಹಾಸಿಗೆ ಮೂಡಿಸೋಕಾಗಲ್ಲ.	ಆಕಾಶ
kannadachetana_Kannada_8	ನೀಲಿ ಸಾಗರದಲ್ಲಿ ಬೆಳ್ಳಿಯ ಮೀನುಗಳು.	ತಾರೆಗಳು
kannadachetana_Kannada_9	ಲಟಪಟ ಲೇಡಿ ಒಂದೆ ಕಣ್ಣು.	ಸೂಜಿ
kannadachetana_Kannada_10	ಕಣ್ಣಿಗೆ ಕಾಣಲಿಲ್ಲ ಕೈಗೆ ಸಿಗೂದಲ್ಲ.	ಗಾಳಿ
kannadachetana_Kannada_11	ಮುಳ್ಳುಗಳಿವೆ ಅಪಾಯವಿಲ್ಲ, ಸಂಖ್ಯೆಗಳಿವೆ ಲೆಕ್ಕದ ಪುಸ್ತಕವಲ್ಲ, ಗಂಟೆ ಹೊಡೆಯುತ್ತದೆ ದೇವಾಲಯವಲ್ಲ.	ಗಡಿಯಾರ
kannadachetana_Kannada_12	ಅಂಗಣ್ಣ ಮಂಗಣ್ಣ ಅಂಗಿ ಬಿಚ್ಚಿ ನುಂಗಣ್ಣ.	ಬಾಳೆಹಣ್ಣು
kannadachetana_Kannada_13	ಬಿಳಿ ಸರದಾರನಿಗೆ ಕರಿ ಟೋಪಿ.	ಬೆಂಕಿಕಡ್ಡಿ
kannadadeevige_Kannada_riddle_1	ಗೂಡಿನಲ್ಲಿನ ಪಕ್ಷಿ ನಾಡೆಲ್ಲ ನೋಡುತ್ತದೆ	ಕಣ್ಣು
kannadadeevige_Kannada_riddle_2	ಎಲೆ ಇಲ್ಲ, ಸುಣ್ಣ ಇಲ್ಲ, ಬಣ್ಣವಿಲ್ಲ ತುಟಿ ಕೆಂಪಗಾಗಿದೆ, ಮಳೆಯಿಲ್ಲ , ಬೆಲೆಯಿಲ್ಲ , ಮೈ ಹಸಿರಾಗಿದೆ	ಗಿಳಿ
kannadadeevige_Kannada_riddle_3	ಮನೆ, ಮನೆಗೆರಡು ಬಾಗಿಲು, ಬಾಗಿಲ ಮುಂದೆ , ಮುಚ್ಚಿದರೆ ಹಾನಿ ಇದೇನು?	ಮೂಗು, ಬಾಯಿ
kannadadeevige_Kannada_riddle_4	ಸುತ್ತ ಮುತ್ತ ಸುಣ್ಣದ ಗೋಡೆ, ಎತ್ತ ನೋಡಿದರೂ ಬಾಗಿಲಿಲ್ಲ ಇದು ಏನು?	ಮೊಟ್ಟೆ
kannadadeevige_Kannada_riddle_5	ಇದ್ದಲು ನುಂಗುತ್ತ , ಗದ್ದಲ ಮಾಡುತ್ತಾ, ಉದ್ದಕ್ಕೂ ಓಡುತ್ತಾ ಮುಂದಕ್ಕೆ ಸಾಗುವ ನಾನ್ಯಾರು?	ರೈಲು
kannadadeevige_Kannada_riddle_6	ಮೊಟ್ಟೆ ಒಡೆಯೋ ಹಾಗಿಲ್ಲ ಕೊಡ ಮುಳುಗಿಸೋ ಹಾಗಿಲ್ಲ ಬರಿ ಕೊಡೆ ತಗೊಂಡು ಬಾರೋ ಹಾಗಿಲ್ಲ	ತೆಂಗು
kannadadeevige_Kannada_riddle_7	ಕಡಿದರೆ ಕಚ್ಚೋಕೆ ಆಗೋಲ್ಲ , ಹಿಡದ್ರೆ ಮುಟ್ಟೋಕೆ ಸಿಗೋಲ್ಲ	ನೀರು
kannadadeevige_Kannada_riddle_8	ಒಂದು ರುಮಾಲು ನಮ್ಮಪ್ಪನೂ ಸುತ್ತಲಾರ.	ದಾರಿ
kannadadeevige_Kannada_riddle_9	ಹುಟ್ಟುತ್ತಲೇ ಹುಡುಗ ತಲೆಯಲ್ಲಿ ಟೋಪಿ ಹಾಕಿರುತ್ತೆ .	ಬದನೆಕಾಯಿ
kannadadeevige_Kannada_riddle_10	ಸಾಗರ ಪುತ್ರ ,ಸಾರಿನ ಮಿತ್ರ.	ಉಪ್ಪು
kannadadeevige_Kannada_riddle_11	ಕಣ್ಣಿಲ್ಲ, ಕಾಲಿಲ್ಲ ,ಆದರು ಚಲಿಸುತಿದೆ ಯಾವುದು ಎಲ್ಲಿದೆ ಬಲ್ಲಿದನ ಹೇಳಿರಲ.	ನದಿ
kannadadeevige_Kannada_riddle_12	ಮೋಟು ಗೋಡೆ ಮೇಲೆ, ದೀಪ ಉರೀತಿದೆ.	ಮೂಗುಬೊಟ್ಟು
kannadadeevige_Kannada_riddle_13	ಕತ್ತಲೆ ಮನೆಯಲಿ ಕಾಳವ್ವ ಕುಂತವ್ಳೆ ಕುಯ್ಯೋ, ಮರ್ರೋ ಅಂತವಳೇ	ತಂಬೂರಿ
kannadadeevige_Kannada_riddle_14	ನೀರಿಲ್ಲದ ಸಮುದ್ರ, ಜನರಿಲ್ಲದ ಪಟ್ಟಣ, ಸಂಚಾರವಿಲ್ಲದ ಮಾರ್ಗಗಳು ಎಲ್ಲಿ?	ನಕ್ಷೆ
kannadadeevige_Kannada_riddle_15	ಒಬ್ಬನನ್ನು ಹಿಡಿದರೆ ಎಲ್ಲಾರ ಮರ್ಜಿಯು ಗೊತ್ತಾಗುತ್ತದೆ.	ಅನ್ನದ ಅಗುಳು
kannadadeevige_Kannada_riddle_16	ಮೇಲೆ ನೋಡಿದರೆ ನಾನಾ ಬಣ್ಣ, ಉಜ್ಜಿದರೆ ಒಂದೇ ಬಣ್ಣ.	ಸಾಬೂನು
kannadadeevige_Kannada_riddle_17	ಒಂದು ಕೊಂಬಿನ ಗುಳಿ ಅದರ ತಲೆಯೆಲ್ಲಾ ಮುಳ್ಳು.	ಬದನೆಕಾಯಿ
kannadadeevige_Kannada_riddle_18	ನಾನು ತುಳಿದೆ ಅದನ್ನ, ಅದು ತುಳಿಯೆತು ನನ್ನನ್ನ.	ನೀರು
kannadadeevige_Kannada_riddle_19	ಕೊಳದ ಒಳಗೆ ಒಂದು ಮರ ಹುಟ್ಟಿ ,ಬೇರು ಇಲ್ಲ ,ನೀರು ಇಲ್ಲ.	ಎಣ್ಣೆ ದೀಪ
kannadadeevige_Kannada_riddle_20	ಬಡ ಬಡ ಬಂದ ಅಂಗಿ ಕಳಚಿದ ,ಬಾವಿಯೊಳಗೆ ಬಿದ್ದ.	ಬಾಳೆ ಹಣ್ಣು
kannadadeevige_Kannada_riddle_21	ನೋಡಿದರೆ ನೋಟಗಳು ,ನಕ್ಕರೆ ನಗುಗಳು ,ಒಡೆದರೆ ತುಂಡುಗಳು.	ಕನ್ನಡಿ
kannadadeevige_Kannada_riddle_22	ಅಕ್ಕ ಪಕ್ಕ ಚದುರಂಗ ,ಅದರ ಹೂವು ಪದುರಂಗ ಅದರ ಹೆಸರು ಅಯ್ಯಯ್ಯಪ್ಪ .ಇದು ಏನು?	ದತ್ತುರಿಯ ಮುಳ್ಳು
kannadadeevige_Kannada_riddle_23	ವನದಲ್ಲಿ ಹುಟ್ಟಿ ,ವನದಲ್ಲಿ ಬೆಳೆದು ,ವನದಿಂದ ಹೊರಟು ವನಜಲೊನೆ ಶಿರಕ್ಕೆರುವರು.	ಕಮಲ
kannadadeevige_Kannada_riddle_24	ಕಲ್ಲು ಕೋಳಿ ಕುಗುತ್ತದೆ, ಮುಲ್ಲ ಚೂರಿ ಹಾಕುತ್ತಾನೆ.	ಗಿರಣಿ
kannadadeevige_Kannada_riddle_25	ಚರಚರ ಕೊಯ್ತದೆ ಕತ್ತಿ ಅಲ್ಲ, ಮಿಣಿಮಿಣಿ ಮಿಂಚುತ್ತದೆ ಮಿಂಚಲ್ಲ, ಪೆಟ್ಟಿಗೆಗೆ ತುಂಬ್ತದೆ ದಾಗಿನ ಅಲ್ಲ.	ಗರಗಸ
kannadadeevige_Kannada_riddle_26	ಕರಿ ಗುಡ್ಡ	ಬಿಳಿ ನೀರು ಅದ್ರಾಗೆ ಕುಂತವಳೇ ಚಂಪರಾಣಿ.-ಗಡಿಗೆಮಜ್ಜಿಗೆ
kannadadeevige_Kannada_riddle_27	ಕೆಂಪು ಕುದುರೆ ಮೇಲೆ ಒಬ್ಬ ಏರುತ್ತಾನೆ, ಒಬ್ಬ ಇಳಿಯುತ್ತಾನೆ .	ರೊಟ್ಟಿ, ದೋಸೆ
kannadadeevige_Kannada_riddle_28	ಕೆಂದ ಕುದುರೆ ,ಬಿಳಿ ತಡಿ, ಕರೆ ಲಗಾಮು, ಅಣ್ಣ ಅತ್ತಾನೆ, ತಮ್ಮ ಇಳಿತ್ತಾನೆ	ಬೆಂಕಿ, ಸುಣ್ಣ ಹಚ್ಚಿದ ಹಂಚು, ಹೊಗೆ, ರೊಟ್ಟಿ
kannadadeevige_Kannada_riddle_29	ಬಾ ಅಂದರೆ ಬರೋಲ್ಲ , ಹೋಗು ಅಂದರೆ ಹೋಗೋಲ್ಲ	ಮಳೆ
kannadadeevige_Kannada_riddle_30	ನಾ ಇರುವಾಗ ಬರುತ್ತೆ , ನಾ ಹೋದ ಮೇಲೂ ಇರುತ್ತೆ	ಕೀರ್ತಿ
kannadadeevige_Kannada_riddle_31	ಕಾಲಿಲ್ದ ಹುಡುಗಿಗೆ ಮಾರುದ್ದ ಕಡಿವಾಣ	ಸೂಜಿ
kannadadeevige_Kannada_riddle_32	ಕೆಂಪು ಕುದುರೆಗೆ ಲಗಾಮು, ಓಬ್ಬ ಹತ್ತುತ್ತಾನೆ , ಇನ್ನೊಬ್ಬ ಇಳಿತಾನೇ	ಬೆಂಕಿ,ಬಾಣಲೆ, ದೋಸೆ
kannadadeevige_Kannada_riddle_33	ಕಲ್ಲರಳಿ ಹೂವಾಗಿ, ಎಲ್ಲರಿಗೂ ಬೇಕಾಗಿ, ಮಲ್ಲಿಕಾರ್ಜುನನ ಗುಡಿಗೆ ಬೆಳಕಾಗಿ, ಬಲ್ಲವರು ಹೇಳಿ	ಸುಣ್ಣ
kannadadeevige_Kannada_riddle_34	ದಾಸ್ ಬುರುಡೆ ದೌಲಥ ಬುರುಡೆ, ಲೋಕಕ್ಕೆಲ್ಲ ಎರಡೇ ಬುರುಡೆ	ಸೂರ್ಯ , ಚಂದ್ರ
kannadadeevige_Kannada_riddle_35	ಹಾರಾಡುತ್ತಿದೆ ಗಾಳಿಪತವಲ್ಲ , ಬಣ್ಣ ಮೂರಿರುವುದು ಕಾಮನಬಿಲ್ಲಲ್ಲ	ಧ್ವಜ
kannadadeevige_Kannada_riddle_36	ಬಿಡಿಸಿದರೆ ಹೂವು, ಮದಚಿದರೆ ಮೊಗ್ಗು ,ಇದು ಏನು?	ಛತ್ರಿ
kannadadeevige_Kannada_riddle_37	ಕಪ್ಪು ಕಂಬಳಿ ನೆಂಟ ಎಲ್ಲವನು ನಾಶ ಮಾಡೋಕೆ ಹೊಂಟ	ಇಲಿ
kannadadeevige_Kannada_riddle_38	ಒಂದು ಮನೆಯಲ್ಲಿ ಮೂರು ಜನ ಅಕ್ಕ	ತಂಗಿಯರಿದ್ದಾರೆ ಆದರೆ ಒಬ್ಬರ ಮುಖ ಕಂಡರೆ ಒಬ್ಬರಿಗೆ ಕಾಣೋಲ್ಲ- ಜಾದಳಕಾಯಿ
kannadadeevige_Kannada_riddle_39	ಅಂಕಡೊಂಕಿನ ಬಾವಿ ಹೊಕ್ಕು ನೋಡಿದ್ರೆ ಮುಕ್ಕ ನೀರಿಲ್ಲ	ಕಿವಿ
kannadadeevige_Kannada_riddle_40	ತಲೆ ಇಲ್ಲ , ನಡು ಇಲ್ಲ , ಕೈಗಳಿದ್ದರು ಬೆರಳಿಲ್ಲ	ಕೋಟು ಅಂಗಿ
kannadadeevige_Kannada_riddle_41	ತಿಂಡಿಗೆ ಕಡಿಮೆ ಇಲ್ಲ ,ತೀರ್ಥ ಕುಡಿದರೆ ಸಾವು	ವಿಷ
kannadadeevige_Kannada_riddle_42	ಒಬ್ಬಳು ಮುಲುಗಿದಳು, ಒಬ್ಬಳು ಕರಗಿದಳು , ಒಬ್ಬಳು ತೇಲಿದಳು	ಅಡಿಕೆ , ಸುಣ್ಣ
kannadadeevige_Kannada_riddle_43	ಕಿರೀಟ ಇದೆ ರಾಜ ಅಲ್ಲ, ಕಲ ತಿಳಿಸುತ್ತ್ತೆ ಗಡಿಯಾರವಲ್ಲ	ಕೋಳಿ
kannadadeevige_Kannada_riddle_44	ಒಂದು ಮರ , ಮರದಾಗ ಅಲ್ಲ, ಅಲ್ಲಿನಾಗ ಕೊಬ್ರಿ ಗುಂಡ	ಆಕಾಶ ನಕ್ಷತ್ರ ಚಂದ್ರ
kannadadeevige_Kannada_riddle_45	ಹುಲಿಯ ಚಿಕ್ಕಮ್ಮ , ಇಲಿಯ ಮುಕ್ಕಮ್ಮ	ಬೆಕ್ಕು
kannadadeevige_Kannada_riddle_46	ಕಲ್ಲಲ್ಲಿ ಹುಟ್ಟುವುದು, ಕಲ್ಲಲ್ಲಿ ಬೆಳೆಯುವುದು, ನೆತ್ತಿಯಲ್ಲಿ ಕುತಗುಟ್ಟುವುದು	ಸುಣ್ಣ
kannadadeevige_Kannada_riddle_47	ಕಾಂತಾಮಣಿ ಎಂಬ ಪಕ್ಷಿ, ಚಿಂತಾಮಣಿ ಎಂಬ ಕೆರೆ, ಕೆರೆಯಲ್ಲಿ ನೀರಿಲ್ದೆ ಹೋದ್ರೆ ಪಕ್ಷಿಗೆ ಮರಣ	ದೀಪ
kannadadeevige_Kannada_riddle_48	ಕಲ್ಲು ತುಳಿಯುತ್ತೆ, ಮುಳ್ಳು ಮೆಯುತ್ತೆ, ನೀರು ಕಂಡ್ರೆ ನಿಲ್ಲುತ್ತೆ	ಚಪ್ಪಲಿ
kannadadeevige_Kannada_riddle_49	ಬಿಳಿ ಆಕಾಶದಲ್ಲಿ ಕಪ್ಪು ನಕ್ಷತ್ರಗಳು,ಇದನ್ನು ನೋಡಲು ಜನ ಕಾದಿಹರು	ನಾಣ್ಯ
kannadadeevige_Kannada_riddle_50	ಹಸಿರು ಮುಖಕ್ಕೆ ವಿಪರೀತ ಕೋಪ , ಕೋಪ ಮಾಡಿಕೊಳ್ಳದೆ ನಾನ್ಯಾರೆಂದು ಹೇಳಿ?	ಮೆಣಸಿನಕಾಯಿ
kannadadeevige_Kannada_riddle_51	ಹಗಲಲ್ಲಿ ಮಾಯಾ ರಾತ್ರಿಯಲ್ಲಿ ಪ್ರತ್ಯಕ್ಷ ?ನಾನ್ಯಾರು ಹೇಳಿ?	ನಕ್ಷತ್ರ
kannadadeevige_Kannada_riddle_52	ಬಾಯಲ್ಲಿ ಹಲ್ಲಿಲ್ಲ, ಮಯಲ್ಲಿ ಶಕ್ತಿ ಇಲ್ಲ , ತಲೆಯಲ್ಲಿ ಕೂದಲಿಲ್ಲ , ಆದ್ರೂ ಎಲ್ರುನ್ನು ಕಾಡತಿನಿ ನಾನ್ಯಾರು.	ಸೊಳ್ಳೆ
kannadadeevige_Kannada_riddle_53	ಕರಿ ಕಂಬ್ಳಿ ನೆಂಟ, ಸರೊತ್ತಿನಲ್ಲಿ ಹೊಂಟ, ಅವನ್ಯಾರು?	ಹೆಗ್ಗಣ
thinkbangalore_Kannada_1	ಕಾಲಿಲ್ಲದೆ ನಡೆಯುವುದು , ಬಾಯಿಲ್ಲದೆ ನುಡಿಯುವುದು, ಇದರ ಹೊಟ್ಟೆ ಹಲವಕ್ಕೆ ಮನೆಯಾಗಿರುವುದು	ನದಿ
thinkbangalore_Kannada_2	ಕುಡಿಕೆಯಲ್ಲಿ ಮೆಣಸು	ಪರಂಗಿ ಹಣ್ಣು
thinkbangalore_Kannada_3	ಹಿಡಿ ಹಿಡಿದರೆ ಹಿಡಿ ತುಂಬಾ ! ಬಿಟ್ಟರೆ ಮನೆ ತುಂಬಾ	ದೀಪ
thinkbangalore_Kannada_4	ಮೇಲೆ ಹಸಿರು , ಒಳಗೆ ಕೆಂಪು , ತಿಂದರೆ ತಂಪು	ಕಲ್ಲಂಗಡಿ
thinkbangalore_Kannada_5	ಹಾರಿದರೆ ಹನುಮಂತ , ಕೂಗಿದರೆ ರಾವಣ , ಕುಳಿತರೆ ಮುನಿರಾಮ	ಕಪ್ಪೆ
thinkbangalore_Kannada_6	ಚಿಕ್ಕ ಮನೇಲಿ ಚಕ್ಕೆ ತುಂಬಿವೆ	ಹಲ್ಲು
thinkbangalore_Kannada_7	ಉದ್ದ ಮರದಲ್ಲಿ ಕೆಂಪು  ಸನ್ಯಾಸಿ	ಅಡಿಕೆ ಕಾಯಿ
thinkbangalore_Kannada_8	ನಿನ್ನ ಹೊಟ್ಟೆಯ ಮೇಲೆ , ನನ್ನ ಹೊಟ್ಟೆ	ರಾಗಿ ಕಲ್ಲು
thinkbangalore_Kannada_9	ಕಲ್ಲರಳಿ ಹೂವಾಗಿ , ಎಲ್ಲರಿಗೂ ಬೇಕಾಗಿ  , ಮಲ್ಲಿಕಾರ್ಜುನನ ಶಿಖರಕ್ಕೆ ಬೆಳಕಾಗಿ ಬಲ್ಲವರು ಹೇಳಿ ಸರ್ವಜ್ಞ	ಸುಣ್ಣ
thinkbangalore_Kannada_10	ಸತ್ತವನೇ ಸಾವಿನ ಸುದ್ದಿ ತಗೊಂಡು ಹೋಗ್ತಾನೆ	ಹಲಸಿನ ಹಣ್ಣು
thinkbangalore_Kannada_11	ಚಿಕ್ಕ ಚಿಕ್ಕ ಪೆಟ್ಟಿಗೆ , ಚಿನ್ನದ ಪೆಟ್ಟಿಗೆ , ಮುಚ್ಚಿ ತೆಗೆದರೆ ಮುನ್ನೂರು ಪೆಟ್ಟಿಗೆ	ದಾಳಿಂಬೆ ಹಣ್ಣು
thinkbangalore_Kannada_12	ಚೆಲ್ಲೋದುಂಟು , ಕುಯ್ಯೋದುಂಟು , ತಿನ್ನೋದಿಲ್ಲ	ಕೂದಲು
thinkbangalore_Kannada_13	ಹತ್ನಾರ್ದ ಮರಕ್ಕೆ , ಹತ್ತುತನೆ ಕರಿಯಣ್ಣ	ಇರುವೆ
thinkbangalore_Kannada_14	ಸಾಯೋವರೆಗೂ ಹೂವಿಲ್ಲ , ಹಣ್ಣು ಮಾತ್ರ ಬಿಡ್ತದೆ	ಹತ್ತಿಹಣ್ಣು
thinkbangalore_Kannada_15	ಕಿರೀಟವುಂಟು ರಾಜನಲ್ಲ , ಗಡ್ಡವುಂಟು ತುರುಕನಲ್ಲ	ಹುಂಜ
thinkbangalore_Kannada_16	ಸುತ್ತಮುತ್ತ ಗರಿಕೆ , ನಡುವೆ ಕುಡಿಕೆ	ಕಣ್ಣು
thinkbangalore_Kannada_17	ಹತ್ತಲಾರದ ಮರ , ಎಣಿಸಲಾರದ ಕಾಯಿ	ರಾಗಿ ಗಿಡ
thinkbangalore_Kannada_18	ರಕ್ತವಿಲ್ಲದ  ಮಾಂಸ , ಕರುಳಿಲ್ಲದ ಹೊಟ್ಟೆ	ಸೀಗಡಿ
thinkbangalore_Kannada_19	ಮುಳ್ಳು ಮುಳ್ಳು ಮರದಲ್ಲಿ , ಮುತ್ತು ಮುತ್ತು ಕಾಯಿ	ನಿಂಬೆ ಹಣ್ಣು
thinkbangalore_Kannada_20	ಸಾಸಿವೆ ಗಾತ್ರದ ಕಲ್ಲು ಬಿದ್ದರೆ , ಸಾವಿರ ರೂಪಾಯಿನ ತೋಟ ಹಾಳು !	ಕಣ್ಣು
thinkbangalore_Kannada_21	ಕಪ್ಪೆ ಮುಟ್ಟದ ಕೈಲಾಸದ ನೀರು !	ಎಳೆನೀರು
thinkbangalore_Kannada_22	ಕಲ್ಲನ್ನು ತುಳಿಯುತ್ತೆ ! ಮುಳ್ಳನ್ನು ಮೂಯುತ್ತೆ ! ನೀರು ಕಂಡ್ರೆ ನಿಲ್ಲುತ್ತೆ !	ಚಪ್ಪಲಿ
thinkbangalore_Kannada_23	ಅಮ್ಮನ ಹಾಸಿಗೆ ಸುತ್ತೊಕ್ಕಾಗಲ್ಲ ! ಅಪ್ಪನ ದುಡ್ಡು ಎಣಿಸೋಕ್ಕಾಗಲ್ಲ !	ಆಕಾಶ , ನಕ್ಷತ್ರಗಳು
thinkbangalore_Kannada_24	ನೀಲಿ ಕೆರೇಲಿ ಬಿಳಿ ಮೀನು	ನಕ್ಷತ್ರ
thinkbangalore_Kannada_25	ಕಣ್ಣಿಗೆ ಕಾಣೋದಿಲ್ಲ ! ಕೈಯಿಗೆ ಸಿಗೋದಿಲ್ಲ !	ಗಾಳಿ
thinkbangalore_Kannada_26	ಮಡಿಸಿದರೆ ಮೊಗ್ಗು ! ಬಿಡಿಸಿದರೆ ಹೂವು ! ಪರಿಮಳವಿಲ್ಲ ವಾಸ್ನೆ ಇಲ್ಲ !	ಕೊಡೆ
thinkbangalore_Kannada_27	ಚಿನ್ನ ಬಿಸಾಡುತ್ತಾರೆ ! ಬೆಳ್ಳಿ ತಿಂತಾರೆ !	ಬಾಳೆ ಹಣ್ಣು
thinkbangalore_Kannada_28	ಅಕ್ಷರಗಳಿದ್ದರೂ ಪುಸ್ತಕವಲ್ಲ ! ಸಿಂಹವಿದ್ದರೂ ಅರಣ್ಯವಲ್ಲ ! ದುಂಡಾಗಿದ್ದರೂ ಚಕ್ರವಲ್ಲ ! ನಾನ್ಯಾರು ?	ನಾಣ್ಯ
thinkbangalore_Kannada_29	ಹೋದ ನೆಂಟ ಬಂದ ನೆಂಟ ! ಬಂದ ದಾರಿ ಗೊತ್ತಿಲ್ಲ	ನೆರಳು
thinkbangalore_Kannada_30	ಕಣ್ಣಿಗೆ ಹತ್ತಿರ , ಕಾಲಿಗೆ ದೂರ	ದಿಗಂತ
thinkbangalore_Kannada_31	ಊರುಂಟು ಜನರಿಲ್ಲ ! ನದಿಯುಂಟು ನೀರಿಲ್ಲ ! ರಸ್ತೆಯುಂಟು ವಾಹನವಿಲ್ಲ !  ಹಾಗಾದರೆ ನಾನ್ಯಾರು ?	ಭೂಪಟ
thinkbangalore_Kannada_32	ಅಣ್ಣ ತಮ್ಮ ಇಬ್ಬರೂ ನಾ ಮುಂದೆ ತಾ ಮುಂದೆ ಎನ್ನುತ್ತಾರೆ ! ಆದರೆ ಯಾರೂ ಮುಂದೆ ಹೋಗುವುದಿಲ್ಲ !	ಕಾಲುಗಳು
thinkbangalore_Kannada_33	ಹೋಗುತ್ತಾ ಬರುತ್ತಾ ಇರುವುದು ಎರಡು , ಎರಡೂ ಹೋದ ಮೇಲೆ ಬರಲಾರವು	ಸಿರಿತನ - ಬಡತನ , ಪ್ರಾಣ - ಮಾನ
thinkbangalore_Kannada_34	ಕಚ್ಚಿದರೆ ಮಾತ್ರ ಕಚ್ಚುವುದು ! ಕಚ್ಚಲ್ಲ , ಹಾವಲ್ಲ , ಚೇಳಲ್ಲ	ಮೆಣಸಿನ ಕಾಯಿ
thinkbangalore_Kannada_35	ಅಂಗಡಿಯಲ್ಲಿ ತರೋದು ಅದರ ಮುಂದು ಕೂತು ಅಳೋದು	ಈರುಳ್ಳಿ
vishaya_Kannada_1	ನೀರಲ್ಲೆ ಹುಟ್ಟುತ್ತೆ ! ನೀರಲ್ಲೆ ಬೆಳೆಯುತ್ತೆ ! ನೀರು ಕಂಡ ಕೂಡಲೆ ಕರಗಿ ಹೋಗುತ್ತೆ !	ಉಪ್ಪು
vishaya_Kannada_2	ಅಪ್ಪನ ದುಡ್ಡು ಎಣಿಸೊಕಾಗಲ್ಲ , ಅವ್ವನ ಸೀರೆ ಮಡಿಸೊಕ್ಕಾಗಲ್ಲ	ನಕ್ಷತ್ರ ಆಕಾಶ
vishaya_Kannada_3	ಕಿರಿ ಮನೆಗೆ ಚಿನ್ನದ ಬೀಗ	ಮೂಗುತಿ
vishaya_Kannada_4	ಊರಿಗೆಲ್ಲ ಒಂದೇ ಕಂಬ್ಳಿ	ಆಕಾಶ
vishaya_Kannada_5	ಯಾರೂ ಹತ್ತಲಾರದ ಮರಕ್ಕೆ ಸರಗೂರು ಕರಿಯಪ್ಪ ಹತ್ತುತ್ತಾನೆ	ಇರುವೆ
vishaya_Kannada_6	ಎಷ್ಟೇ ಮಳೆ ಬಂದರೂ ನೆನೆಯುವುದಿಲ್ಲ	ಎಮ್ಮೆ ಕೆಚ್ಚಲು
vishaya_Kannada_7	ಮರದೊಳಗೆ ಮರ ಹುಟ್ಟಿ , ಭೂ ಚಕ್ರದ ಹಣ್ಣಾಗಿ , ತಿನ್ನಬಾರದ ಹಣ್ಣು ಬಲು ಚಂದ	ಎಳೇ ಕೂಸು
vishaya_Kannada_8	ಊರಿನಲ್ಲಿ ಕುರಿ ಕೂಗಿದರೆ ಮೈಯೆಲ್ಲಾ ತೂತು	ಒಂದರಿ
vishaya_Kannada_9	ಮಳೆ ಹುಯ್ಲಿ , ಹುಯ್ದೆ ಇರ್ಲಿ ಬಾಯಲ್ಲಾ ಕೆಂಪು , ಮೈಯೆಲ್ಲಾ ಹಸಿರು	ಗಿಳಿ
vishaya_Kannada_10	ನೀರುಂಟ್ಟು ಬಾವಿಯಲ್ಲ , ಜುಟ್ಟುಂಟು ಪೂಜಾರಿಯಲ್ಲ , ಮೂರು ಕಣ್ಣುಂಟು ಶಿವನಲ್ಲ	ತೆಂಗಿನಕಾಯಿ
vishaya_Kannada_11	ಒಳ್ಳೆ ಕೋಳಿ ಮುಳ್ಳಲಿ ಮೊಟ್ಟೆ ಇಕ್ಕದೆ	ನಿಂಬೆಹಣ್ಣು
vishaya_Kannada_12	ತಂದವರೊಬ್ಬರು ! ಹಿಡಿದವರೊಬ್ಬರು ! ಹೊತ್ತವರೊಬ್ಬರು	ಬಳೆ
vishaya_Kannada_13	ಬಿಳಿ ಹುಡುಗನಿಗೆ ಕರಿಟೋಪಿ ,	ಬೆಂಕಿ ಕಡ್ಡಿ
vishaya_Kannada_14	ಒಂದೇ ಕುಪ್ಪಿಲಿ , ಎರಡು ತರಾ ತುಪ್ಪ !	ಮೊಟ್ಟೆ
vishaya_Kannada_15	ಒಬ್ಬಣ್ಣ ಇಳಿತಾನೆ ಒಬ್ಬಣ್ಣ ಹತ್ತುತ್ತಾನೆ	ರೊಟ್ಟಿ
vishaya_Kannada_16	ಹೊಕ್ಕುವಾಗ ಒಂದು ಹೊರಟಾಗ ನೂರು	ಶ್ಯಾವಿಗೆ
vishaya_Kannada_17	ನಿಂಗಕ್ಕ ನೀರಕ್ಕ , ಹಾಕುವವರುಂಟು ತೆಗೆಯುವವರಿಲ್ಲ , ಅದೇನಕ್ಕ ?	ಹಚ್ಚೆ
vishaya_Kannada_18	ಮೂವತ್ತೆರಡು ಜನ ಅಗಿತ್ತಾರೆ , ಒಬ್ಬ ರುಚಿ ನೋಡ್ತಾನೆ	ಹಲ್ಲು , ನಾಲಿಗೆ
vishaya_Kannada_19	ಊರಿಗೆಲ್ಲಾ ಒಂದೇ ಕಂಬ್ಳಿ	ಆಕಾಶ
vishaya_Kannada_20	ಬಂಡೆಯ ಮೇಲೆ ಮಲಗುತ್ತೆ , ತಂತಿ ಮೇಲೆ ಕುಣಿಯತ್ತೆ	ಒಣಗಲು ಹಾಕಿದ ಬಟ್ಟೆ
vishaya_Kannada_21	ಬಿಳೀ ಕಲ್ಮೇಲೆ ಕರಿಕಲ್ಲು , ಕರೀ ಕಲ್ಮೇಲೆ ರಂಗೋಲೆ	ಕಣ್ಣು
vishaya_Kannada_22	ಕಪ್ಪುಂಟು ಕಸ್ತೂರಿಯಲ್ಲ , ಬಿಳ್ಪುಂಟು ಸುಣ್ಣವಲ್ಲ , ನೀರುಂಟು ಬಾವಿಯಲ್ಲ , ರೆಕ್ಕೆಯುಂಟು ಪಕ್ಷಿಯಲ್ಲ.	ಕಣ್ಣು
vishaya_Kannada_23	ಅಂಕು ಡೊಂಕಿನ ಮರ, ಕಚ್ಚಿದವರ ಬಾಯಿಗೆ , ಉಚ್ಚಿ ಹುಯ್ಯುವ ಮರ	ಕಬ್ಬು
vishaya_Kannada_24	ಕರಿ ಮಂಚದ ಮೇಲೆ , ಹಾಕುವ ಹಾಸಿಗೆ , ತೆಗೆಯುವ ಹಾಸಿಗೆ	ಕಾವಲಿ ದೋಸೆ
vishaya_Kannada_25	ತೂತಿಲ್ಲದ ಒಡವೆ	ಕುಂಕುಮ
vishaya_Kannada_26	ಅಟ್ಟದ ತುಂಬಾ ಹಗ್ಗ ಹಾಸೈತೆ , ಅದರ ಮೇಲೆ ಭೂತ ಕೂತವ್ನೆ ,	ಕುಂಬಳ ಕಾಯಿ
vishaya_Kannada_27	ನಾಲ್ಕು ಕಾಲುಗಳುಂಟು ಪ್ರಾಣಿಯಲ್ಲ ! ಬೆನ್ನು ತೋಳುಂಟು ಮನುಷ್ಯನಲ್ಲ	ಕುರ್ಚಿ
vishaya_Kannada_28	ಅಕ್ಕಣ್ಣನಿಗೆ ಆರು ಕಣ್ಣು , ಮುಕ್ಕಣ್ಣಂಗೆ ಮೂರು ಕಣ್ಣು , ಲಿಂಗಪ್ಪನಿಗೆ ಒಂದೇ ಕಣ್ಣು	ಕೊಳಲು , ತೆಂಗಿನಕಾಯಿ , ಸೂಜಿ
vishaya_Kannada_29	ಒಂದು ಸುಣ್ಣದ ಗೋಡೆಗೆ , ಒಂದೂ ಬಾಗಿಲಿಲ್ಲ	ಕೋಳಿ ಮೊಟ್ಟೆ
vishaya_Kannada_30	ಚಿಕ್ಕವನು ಒಬ್ಬನಿಗೆ ಬಡಿಸುವಷ್ಟರಲ್ಲಿ ದೊಡ್ಡವನು ಹನ್ನೆರಡು ಮಂದಿಗೆ ಬಡಿಸಿರ್ತಾನೆ	ಗಡಿಯಾರ
vishaya_Kannada_31	ಗರಿಕೆ ಆಸೆ ದೇವರು ! ವರ್ಶಕ್ಕೊಮ್ಮೆ ಬರ್ತಾನೆ	ಗಣಪತಿ
vishaya_Kannada_32	ಕೆಂಪು ಹೆಣ್ಣಿನ ತುಟಿ ಕರೀಗಿದೆ	ಗುಲಗಂಜಿ
vishaya_Kannada_33	ಅಜ್ಜನ್ನ ಹೊಟ್ಟೆ ಹಿಡ್ಕೊಂಡು , ಮೊಮ್ಮಗ ನೇತಾಡ್ತಾ ಅವ್ನೆ	ಗೇರುಬೀಜ
vishaya_Kannada_34	ನೋಡಿದರೆ ಮಲ್ಲಿಗೆ ಹೂ , ಕೈಲಿ ತಕ್ಕಂಡು ಮುಟ್ಟೋಕ್ಕೆ ಆಗೋದಿಲ್ಲ	ಚುಕ್ಕಿ
vishaya_Kannada_35	ಅರಳುತ್ತೆ , ಹೂವಲ್ಲ ! ಬಿಸಿಲಿಗೆ ಬಾಡುವುದಿಲ್ಲ	ಛತ್ರಿ
vishaya_Kannada_36	ಆರು ಕಾಲು ಅಪ್ಪಣ್ಣ ಕೆರೆ ಬೋರಣ್ಣ ಕೂತುತಾವು ಮೀಸೆ ತಿರುವಣ್ಣ	ಜಿರಲೆ
vishaya_Kannada_37	ಅಪ್ಪಾಂದ್ರೆ ಹೊಡಿತದೆ , ಅವ್ವಾಂದ್ರೆ ಹೊಡಿದಿಲ್ಲ	ತುಟಿಗಳು
vishaya_Kannada_38	ನಾಲ್ಕು ಕಾಲುಂಟ್ಟು ಮೃಗವಲ್ಲ , ಹಾರೋದುಂಟು ಪಕ್ಷಿಯಲ್ಲ, ನಾನು ಕೂಸುಗಳನ್ನು ಪ್ರೀತಿಸುವ ಹಾಗೆ ಬೇರೆ ಯಾರು ಇಲ್ಲ !	ತೊಟ್ಟಿಲು
vishaya_Kannada_39	ಚಿಕ್ಕ ಚಿಕ್ಕ ಪೆಟ್ಟಿಗೆ , ಚಿನ್ನದ ಪೆಟ್ಟಿಗೆ , ಮುಚ್ಚಳ ತೆಗೆದರೆ ಮುನ್ನೂರು ಪೆಟ್ಟಿಗೆ	ದಾಳಿಂಬೆ ಹಣ್ಣು
vishaya_Kannada_40	ಹಿಡಿ ಹಿಡಿದರೆ ಹಿಡಿ ತುಂಬಾ ! ಬಿಟ್ಟರೆ ಮನೆ ತುಂಬಾ !	ದೀಪದ ಬೆಳಕು
vishaya_Kannada_41	ಆಡಿ ಓಡಾಡೋ ಗಾಡಿಗೆ , ಆರಡಿ ನೆಲವಷ್ಟೇ ಸ್ವಂತ	ದೇಹ , ಸ್ಮಶಾನ
vishaya_Kannada_42	ಅಪ್ಪನ ದುಡ್ಡು ಎಣಿಸೊಕ್ಕಾಗಲ್ಲ ! ಅವ್ವನ ಸೀರೆ ಮಡ್ಸೊಕಾಗಲ್ಲ !	ನಕ್ಷತ್ರ – ಆಕಾಶ
vishaya_Kannada_43	ನೀರಿನಲ್ಲಿ ಹಾಕಿದರೆ ಮುಳುಗುವುದಿಲ್ಲ ! ಬೆಂಕಿಯಲ್ಲಿ ಸುಡುವುದಿಲ್ಲ , ಕಲ್ಲಲ್ಲ ! ಇದು ಇಲ್ಲದವರಿಲ್ಲ	ನೆರಳು
vishaya_Kannada_44	ಹರಯದಲ್ಲಿ ಹಸಿರು , ದುರದಲ್ಲಿ ಕೆಂಪು , ಮುಪ್ಪಿನಲ್ಲಿ ಕಪ್ಪು	ನೆರಳೆ ಹಣ್ಣು
vishaya_Kannada_45	ಆರು ಗೆರೆವುಂಟು , ಈರೆಕಾಯಲ್ಲ ! ಹುಳಿವುಂಟು , ಹುಣಸೆ ಅಲ್ಲ ! ಹಳದಿವುಂಟು , ನಿಂಬೆ ಹಣ್ಣಲ್ಲ !	ನೆಲ್ಲಿಕಾಯಿ
vishaya_Kannada_46	ಅಪ್ಪ ಅಪ್ಪ ಮರ ನೋಡು , ಮರದೊಳಗೆ ಎಲೆ ನೋಡು , ಎಳೆಯೊಳಗೆ ತೂತು ನೋಡು , ತೂತೊಳಗೆ ಮಾತು ನೋಡು	ಪುಸ್ತಕ
vishaya_Kannada_47	ನಾಲಿಗೆಯುಂಟು , ಮಾತಾಡುವುದಿಲ್ಲ ! ಮುಳ್ಳುಂಟು , ಪೊದೆಯಲ್ಲ !	ಪೆನ್ನು
vishaya_Kannada_48	ಕಾಲುಂಟು ಕೈಯಿಲ್ಲ ! ನಡುವುಂಟು ತಲೆಯಿಲ್ಲ ! ರಂಧ್ರಗಳ್ಳುಂಟು	ಪ್ಯಾಂಟು
vishaya_Kannada_49	ಬೆನ್ನಿನಿಂದ ತಿನ್ನುವುದು , ಬಾಯಿಂದ ಉಗುಳುವುದು , ಎದುರಾದವರನ್ನು ಕೊಲ್ಲುವುದು, ಹಾಗಾದರೆ ನಾನು ಯಾರು	ಬಂದೂಕ
vishaya_Kannada_50	ಅಂಗಣ್ಣ ಮಂಗಣ್ಣ ಅಂಗಿ ಬಿಚ್ಚಣ್ಣ , ಬಾವಿಗೆ ಹಾಕಣ್ಣ	ಬಾಳೆ ಹಣ್ಣು
vishaya_Kannada_51	ಕುತ್ತಿಗೆಗೆ ಹಾಕಿದರೆ ಬರುತ್ತೆ , ಇಲ್ಲದಿದ್ದರೆ ಇಲ್ಲ	ಬಿಂದಿಗೆ
vishaya_Kannada_52	ಗಿರಿರಾಜನ ಮಗಳ ಗಂಡನ ಹಿರಿ ಮಗನ ತಮ್ಮನ ವಾಹನದ ವೈರಿ	ಬೆಕ್ಕು –> ಗಿರಿರಾಜನ ಮಗಳು – ಪಾರ್ವತಿ , ಪಾರ್ವತಿ ಗಂಡ – ಶಿವ , ಶಿವನ ಹಿರಿ ಮಗ – ಸುಬ್ರಮಣ್ಯ , ಸುಬ್ರಮಣ್ಯನ ತಮ್ಮ – ಗಣೇಶ , ಗಣೇಶನ ವಾಹನ – ಇಲಿ , ಇಲಿಯ ವೈರೀ – ಬೆಕ್ಕು
vishaya_Kannada_53	ಗೋಡೆ ಮೇಲೆ ಕರೀ ರೊಟ್ಟಿ	ಬೆರಣಿ
vishaya_Kannada_54	ನಾರಾಯಣ ಕಟ್ಟಿಸಿದ , ನಾಲ್ಕು ಮೂಲೆ ಬಾವಿ , ನೀರಿಲ್ಲ, ಮೀನಿಲ್ಲ	ಬೆಲ್ಲದ ಅಚ್ಚು
vishaya_Kannada_55	ಬಿಳಿಯ ಪೊರೆ ಬಿಡುವ ನಾಗವಲ್ಲ ! ಗುಂಡಗಿರುವೆ ಗೋಲಿಯ ಗುಂಡಲ್ಲ! ದೇಹವು ಮಡಿಕೆಗಳಿಂದ ಕೂಡಿರುವುದು , ಕುಂಬಳ ಕಾಯಲ್ಲ ,	ಬೆಳ್ಳುಳ್ಳಿ
vishaya_Kannada_56	ಊರುಂಟು ಜನರಿಲ್ಲ ! ನದಿಯುಂಟು ನೀರಿಲ್ಲ ! ರಸ್ತೆಯುಂಟು ವಾಹನವಿಲ್ಲ ! ಹಾಗಾದರೆ ನಾನ್ಯಾರು ?	ಭೂಪಟ
vishaya_Kannada_57	ಮಣ್ಣಿನಲ್ಲಿ ಹುಟ್ಟಿ , ಮಣ್ಣಿನಲ್ಲಿ ಬೆಳೆದು , ಮಣ್ಣಿನಲ್ಲಿ ಸಾಯುವುದು ,	ಮಡಿಕೆ
vishaya_Kannada_58	ಹಗಲು ನಿದ್ರಿಸುವೆನು , ರಾತ್ರಿ ಕಣ್ಣು ತೆರೆಯುವೆನು , ಯಾರು ನಾನು ?	ರಸ್ತೆ ದೀಪ
vishaya_Kannada_59	ನೆತ್ತಿಯಲ್ಲಿ ಉಣ್ಣುವುದು, ಸುತ್ತಲೂ ಸುರಿಸುವುದು , ಎತ್ತಿದರೆ ಎರಡು ಹೋಳಾಗುವುದು ,	ರಾಗಿಕಲ್ಲು
vishaya_Kannada_60	ಒಂದು ಕಂಬ , ಅದಕ್ಕೆ ನಾಲ್ಕು ಕಿವಿಗಳು , ಅದರ ಮೆಲೊಂದು ಗುಂಡು	ಲವಂಗ
vishaya_Kannada_61	ಅಂಗಡಿಯಲ್ಲಿ ಮಾರುವುದಿಲ್ಲ , ತಕ್ಕಡಿಯಲ್ಲಿ ತೂಗುವುದಿಲ್ಲ , ಅದಿಲ್ಲದಿದ್ದರೆ ನಮ್ಮ ಮನೆಯಲ್ಲಿ ಹಬ್ಬ ಆಗುವುದೇ ಇಲ್ಲ	ಸಗಣಿ
vishaya_Kannada_62	ಬಿಳಿ ಲಂಗದ ಹುಡುಗಿ ! ಎಳೆದರೆ ಬರ್ತಾಳೆ ! ಬಿಟ್ಟರೆ ಓಡ್ತಾಳೆ	ಸಿಗರೇಟ್ ಹೊಗೆ
vishaya_Kannada_63	ರಕ್ತವಿಲ್ಲದ ಮಾಂಸ , ಕರುಳಿಲ್ಲದ ಹೊಟ್ಟೆ	ಸೀಗಡಿ
vishaya_Kannada_64	ಕಲ್ಲರಳಿ ಹೂವಾಗಿ , ಎಲ್ಲರಿಗೂ ಬೇಕಾಗಿ , ಮಲ್ಲಿಕಾರ್ಜುನನ ಶಿಖರಕ್ಕೆ ಬೆಳಕಾಗಿ ಬಲ್ಲವರು ಹೇಳಿ ಸರ್ವಜ್ಞ	ಸುಣ್ಣ
vishaya_Kannada_65	ಕತ್ತಲೆ ಮನೆಯಲ್ಲಿ ಕಂಬ ಬಿದ್ದರೆ , ನಿಮ್ಮಪ್ಪನೂ ಎತ್ತಲಾರ , ನಮ್ಮಪ್ಪನೂ ಎತ್ತಲಾರ	ಸೂಜಿ
vishaya_Kannada_66	ಬೇಲಿ ನುಗ್ಗೋ ನಾಯಿಗೆ ತಿಕದಲ್ಲಿ ಜನಿವಾರ	ಸೂಜಿ
vishaya_Kannada_67	ಅವ್ವ ನೋಡುದ್ರೆ ಕುಳ್ಳಿ , ಮಗಳ ನೋಡುದ್ರೆ ಮಾರುದ್ದ ಅವ್ಳೆ	ಸೂಜಿ ದಾರ
vishaya_Kannada_68	ಅಕ್ಕನ ಕೈಗೆ ಇಕ್ಕೊರುಂಟು , ಅಳಿಸೋರಿಲ್ಲ ,	ಹಚ್ಚೆ
vishaya_Kannada_69	ಚಂದ್ರನಂತೆ ಗುಂಡಾಗಿ ಎಲೆಗಿಂತಲೂ ತೆಳುವಾಗಿ, ತಿಂದರೆ ಬಲು ರುಚಿ	ಹಪ್ಪಳ
vishaya_Kannada_70	ಅವ್ವ ಮುಳ್ಳಿ , ಮಗಳು ಕೆಂಪ್ಗೆ ಚಂದಾಗವಳೆ	ಹಲಸು
vishaya_Kannada_71	ಹತ್ತು ತಲೆಯುಂಟು ರಾವಣನಲ್ಲ , ಬಾಲವುಂಟು ಹನುಮಂತನಲ್ಲ , ಕಿರೀಟವುಂಟು ರಾಜನಲ್ಲ , ನಾನು ಯಾರು ?	ಹೀರೇಕಾಯಿ
vishaya_Kannada_72	ಆಕಡೆ ಈಕಡೆ ಬೆಟ್ಟ , ಮಧ್ಯದಲ್ಲಿ ಹುಲಿ ಕೂಗುತ್ತೆ	ಹೂಸು
vishaya_Kannada_73	ಉದ್ದ ಮರದಲ್ಲಿ ಕೆಂಪು ಸನ್ಯಾಸಿ	ಅಡಿಕೆ ಕಾಯಿ
vishaya_Kannada_74	ತಲೆ ಮೇಲೆ ಹರಳು , ಬಾಯಲ್ಲಿ ಬೆರಳು	ಉಂಗುರ
