dheivegam_Tamil_riddle_265_1	இவன் வாலுக்கு வையகமே நடுங்கும் அவன் யார்?	தேள்
dheivegam_Tamil_riddle_265_2	பிடுங்கலாம் நடமுடியாது அது என்ன?	தலைமுடி
dheivegam_Tamil_riddle_265_3	உடம்பில்லா ஒருவன் பத்து சட்டை அணீந்திருப்பான்? அவன் யார்?	வெங்காயம்
dheivegam_Tamil_riddle_265_4	கசக்கிப் பிழிந்தாலும் கடைசிவரை இனிப்பான். அவன் யார்?	கரும்பு
dheivegam_Tamil_riddle_265_5	மரத்தின் மேலே தொங்குவது மலைப் பாம்பல்ல அது என்ன?	விழுது
dheivegam_Tamil_riddle_265_6	இடி இடிக்கும், மின்னல் மின்னும், மழை பெய்யாது- அது என்ன?	பட்டாசு
dheivegam_Tamil_riddle_265_7	ஆலமரம் தூங்க அவனியெல்லாம் தூங்க, சீரங்கம் தூங்க திருப்பாற்கடல் தூங்க, ஒருவன் மட்டும் தூங்கவில்லை அவன் யார்?	மூச்சு
dheivegam_Tamil_riddle_265_8	கொதிக்கும் கிணற்றில் குதித்துக் குண்டாகி வருவான். அவன் யார்?	பூரி
dheivegam_Tamil_riddle_265_9	கருப்பு நிறமுடையவன், கபடம் அதிகம் கொண்டவன், கூவி அழைத்தால் வந்திடுவான், கூட்டம் சேர்த்தும் வந்திடுவான் – அவன் யார்?	காகம்
dheivegam_Tamil_riddle_265_10	பச்சை பொட்டிக்குள் வெள்ளை முத்துகள்?	வெண்டைக்காய்
dheivegam_Tamil_riddle_265_11	சிறு தூசி விழுந்ததும் குளமே கலங்கியது அது என்ன?	கண்
dheivegam_Tamil_riddle_265_12	ஓடெடுப்பான் பிச்சை ஒரு நாளும் கண்டறியான் காடுறைவான் தீர்த்தக் கரைசேர்வான்- தேட நடக்குங்கால் நாலுண்டு நல்தலை ஒன்றுண்டு! படுக்கும்போது அவையில்லை பார்! அது என்ன?	ஆமை
dheivegam_Tamil_riddle_265_13	வெள்ளை ஆடை உடுத்திய மஞ்சள் மகாராணி? அவள் யார்?	முட்டை
dheivegam_Tamil_riddle_265_14	எங்க அக்கா சிவப்பு, குளித்தால் கருப்பு அது என்ன ?	அடுப்புக்கரி
dheivegam_Tamil_riddle_265_15	உங்களுக்கு சொந்தமானத ஒன்று ஆனால் உங்களை விட மற்றவர்களே அதிகம் உபயோகிப்பார்கள்?	பெயர்
dheivegam_Tamil_riddle_265_16	யாரும் செய்யாத கதவு தானே திறக்கும் தானே மூடும். அது என்ன?	இமை
dheivegam_Tamil_riddle_265_17	வாயிலே தோன்றி வாயிலே மறையும் பூ. அது என்ன?	சிரிப்பு
dheivegam_Tamil_riddle_265_18	வீட்டில் வளரும் என்னை திருடனுக்கு பிடிக்காது அது என்ன?	நாய்
dheivegam_Tamil_riddle_265_19	இலையுண்டு கிளையில்லை,பூ உண்டு மணமில்லை,காய் உண்டு விதையில்லை,பட்டை உண்டு கட்டை இல்லை,கன்று உண்டு பசு இல்லை அது என்ன?	வாழை
dheivegam_Tamil_riddle_265_20	வெளியே உள்ளதை எறிந்து உள்ளே உள்ளதை சமைத்தான். பின் வெளியே உள்ளதை சாப்பிட்டு விட்டு உள்ளே உள்ளதை எறிந்தான் அது என்ன?	சோளம்
dheivegam_Tamil_riddle_265_21	கடைசி வார்த்தையில் மானம் உண்டு, முதல் வார்த்தையின் மென்மைக்காக இறந்தன பூச்சிகள். காஞ்சியில் நான் யார்?	பட்டுத்துணி
dheivegam_Tamil_riddle_265_22	படபடக்கும், பளபளக்கும், பண்டிகை வந்தால் வானில் பறக்கும். அது என்ன ?	பட்டாசு
dheivegam_Tamil_riddle_265_23	ஓர் அரண்மனையில் முப்பத்திரெண்டு காவலர்கள் அது என்ன?	பற்கள்
dheivegam_Tamil_riddle_265_24	உணவை எடுப்பான் ஆனால் உண்ணமாட்டான் அவன் யார்?	அகப்பை
dheivegam_Tamil_riddle_265_25	காலையில் வந்த விருந்தாளியை மாலையில் காணவில்லை. அது என்ன?	சூரியன்
dheivegam_Tamil_riddle_265_26	கந்தல் துணி கட்டியவன், முத்துப் பிள்ளைகளைப் பெற்று மகிழ்ந்தான். அது என்ன?	சோளக்கதிர்
dheivegam_Tamil_riddle_265_27	கடல் நீரில் வளர்ந்து , மழை நீரில் மடிவது என்ன ?	உப்பு
dheivegam_Tamil_riddle_265_28	ஓயாமல் இரையும் இயந்திரமல்ல, உருண்டோடிவரும் பந்து அல்ல அது என்ன?	கடல்
dheivegam_Tamil_riddle_265_29	காலையிலும் மாலையிலும் நெட்டை மதியம் குட்டை நான் யார்?	நிழல்
dheivegam_Tamil_riddle_265_30	இரு கொம்புகள் உண்டு மாடு அல்ல, வேகமாய் ஓடும் மான் அல்ல, கால்கள் உண்டு மனிதனல்ல. – அது என்ன?	சைக்கிள்
dheivegam_Tamil_riddle_265_31	இவனும் ஒரு பேப்பர் தான்; ஆனால், மதிப்போடு இருப்பான். அது என்ன?	பணம்
dheivegam_Tamil_riddle_265_32	கன்று நிற்க கயிறு மேயுது அது என்ன?	பூசனிக்கொடி
dheivegam_Tamil_riddle_265_33	எப்போதும் மழையில் நனைவான் ஆனால் ஜுரம் வராது. எப்போதும் வெயிலில் காய்வான் ஆனால் ஏதும் ஆகாது. அவன் யார்?	குடை
dheivegam_Tamil_riddle_265_34	தொடாமல் அழுவான், தொட்டால் பேசுவான். அவன் யார்?	தொலைபேசி
dheivegam_Tamil_riddle_265_35	பெட்டியைத் திறந்தால் பூட்ட முடியாது. அது என்ன?	தேங்காய்
dheivegam_Tamil_riddle_265_36	தன் மேனி முழுவதும் கண்ணுடையாள் தன்னிடம் சிக்கியபேரைச் சீரழிப்பாள் அவள் யார்?	மீன்
dheivegam_Tamil_riddle_265_37	வலை படபடக்கும்,பளபளக்கும் மனதுக்குள் இடம் பிடிக்கும் அது என்ன?	பட்டாசு
dheivegam_Tamil_riddle_265_38	உயிரில்லாதவனுக்கு உடம்பெல்லாம் நரம்பு, அது என்ன?	பாய்
dheivegam_Tamil_riddle_265_39	மாமா போட்ட பந்தல் மறுபடி பிரிச்சா கந்தல் அது என்ன?	சிலந்தி வலை
dheivegam_Tamil_riddle_265_40	கீழேயும் மேலேயும் மண்; நடுவிலே அழகான பெண். அது என்ன?	மஞ்சல்செடி.
dheivegam_Tamil_riddle_265_41	சொன்ன நேரத்துக்கு தொண்டை கிழிய கத்துவான். அவன் யார் ?	அலாரம்
dheivegam_Tamil_riddle_265_42	உயிர் இல்லாத நீதிபதியிடம் ஒழுங்கான நியாயம்- அது என்ன?	தராசு
dheivegam_Tamil_riddle_265_43	பூவோடு பிறந்து; நாவோடு கலந்து விருந்தாவான் மருந்தாவான். அவன் யார்?	தேன்
dheivegam_Tamil_riddle_265_44	நூல் நூற்கும் நெசவாளிக்கு கட்டிக்கொள்ள துணியில்லை அது என்ன?	சிலந்தி
dheivegam_Tamil_riddle_265_45	உடம்பெல்லாம் சிவப்பு, அதன் குடுமி பச்சை அது என்ன?	தக்காளி
dheivegam_Tamil_riddle_265_46	ஒட்டுத் திண்ணையில் பட்டுப் பாவாடை அது என்ன?	தோடு
dheivegam_Tamil_riddle_265_47	தலைக்குள் கண் வைத்திருப்பவன் இவன் மட்டும்தான் அவன் யார்?	நுங்கு
dheivegam_Tamil_riddle_265_48	செய்தி வரும் பின்னே, மணியோசை வரும் முன்னே. அது என்ன?	தொலைபேசி
dheivegam_Tamil_riddle_265_49	வாயிலிருந்து நூல் போடுவான்; மந்திரவாதியும் இல்லை, கிளைக்குக் கிளை தாவுவான்; குரங்கும் இல்லை, வலைவிரித்துப் பதுங்கியிருப்பான்; வேடனும் இல்லை – அவன் யார்?	சிலந்தி
dheivegam_Tamil_riddle_265_50	பா‌ர்‌க்க‌த்தா‌ன் கறுப்பு; ஆனா‌ல் உள்ளமோ சிவப்பு. நம‌க்கு‌த் தருவதோ சுறுசுறு‌ப்பு அது என்ன?	தேயிலை
dheivegam_Tamil_riddle_265_51	பல் துவக்ககாதவனுக்கு உடம்பு எல்லாம் பற்கள்?	சீப்பு
dheivegam_Tamil_riddle_265_52	கடலிலே கலந்து, கரையிலே பிரிந்து, தெருவிலே திரியும் பூ எது?	உப்பு 4
dheivegam_Tamil_riddle_265_53	. பற்கள் இருக்கும் கடிக்கமாட்டான் அவன் யார்?	சீப்பு
dheivegam_Tamil_riddle_265_54	வால் நீண்ட குருவிக்கு வாயுண்டு. வயிறில்லை. அது என்ன?	அகப்பை
dheivegam_Tamil_riddle_265_55	காதை திருகினால் பாட்டு பாடுவான்? அவன் யார்?	ரேடியோ
dheivegam_Tamil_riddle_265_56	நடுவழிய ஓய்வுக்காம், கடையிரண்டில் ஏதுமில்லை சொல், மூன்றெழுத்தில் உடுத்தலாம், மொத்தத்தில் பெண்கள் விருப்பம், அது என்ன?	பட்டு
dheivegam_Tamil_riddle_265_57	நாளெல்லாம் நடந்தாலும் நாற்பதடி செல்லாது அந்த நாயகனுக்கோ உடல் மேல் கவசம் அது என்ன?	நத்தை
dheivegam_Tamil_riddle_265_58	நீளவால் குதிரையின் வால் ஓடஓடக் குறையும் அது என்ன?	தையல் ஊசியும் நூலும்
dheivegam_Tamil_riddle_265_59	வீட்டுக்கு வந்த தொந்தியப்பன் தினமும் கரைகிறான். அவன் யார்?	நாட்காட்டி
dheivegam_Tamil_riddle_265_60	முறையின்றித் தொட்டால்,ஒட்டிக் கொண்டு உயிரை எடுப்பான் அவன் யார்?	மின்சாரம்
dheivegam_Tamil_riddle_265_61	வீட்டுக்கு வந்த விருந்தாளியை வரவேற்க ஆளில்லை. அது என்ன?	செருப்பு
dheivegam_Tamil_riddle_265_62	மரத்துக்கு மரம் தாவுவான் குரங்கல்ல, பட்டை போட்டிருப்பான் சாமி அல்ல, அவன் யார்?	அணில்
dheivegam_Tamil_riddle_265_63	நீரிலும் வாழ்வேன், நிலத்திலும் வாழ்வேன். நீண்ட ஆயுள் உடைய எனக்கு இறைவன் கொடுத்த கவசமும் இருக்கு. நான் யார்?	ஆமை
dheivegam_Tamil_riddle_265_64	தாய் குப்பையிலே, மகள் சந்தையிலே அவை என்ன?	நெல்
dheivegam_Tamil_riddle_265_65	பூ பூக்கும். காய் காய்க்கும். ஆனால் பழம் பழக்காது. அது என்ன?	தேங்காய்
dheivegam_Tamil_riddle_265_66	கையை வெட்டுவார்; கழுத்தை வெட்டுவார். ஆனாலும் நல்லவர். யார் அவர்?	தையல்காரர்
dheivegam_Tamil_riddle_265_67	வயதான பலருக்கு புதிதாக ஒரு கை அது என்ன?	வழுக்கை / பொக்கை
dheivegam_Tamil_riddle_265_68	இளமையில் பச்சை, முதுமையில் சிகப்பு, குணத்திலே எரிப்பு. விடை தெரியுமா?	மிளகாய்
dheivegam_Tamil_riddle_265_69	எவ்வளவு முயன்றாலும் அவனை கடிக்க முடியாது. அவன் இல்லாமல் உணவே இல்லை. அவன் யார்?	தண்ணீர்
dheivegam_Tamil_riddle_265_70	கண்ணால் பார்க்கலாம் கையால் பிடிக்கமுடியாது அது என்ன?	நிழல்
dheivegam_Tamil_riddle_265_71	நான்கு கால்கள் உள்ளவன், இரண்டு கைகள் உள்ளவன், உட்கார்ந்து கொண்டிருப்பான், உட்கார இடம் கொடுப்பான் அவன் யார்?	நாற்காலி
dheivegam_Tamil_riddle_265_72	சட்டையைக் கழற்றினால் சத்துணவு அது என்ன?	வாழைப்பழம்
dheivegam_Tamil_riddle_265_73	ஒரு குகை, 32 வீரர்கள் , ஒரு நாகம் அது என்ன?	வாய்
dheivegam_Tamil_riddle_265_74	கையில்லாமல் நீந்துவான்; கால் இல்லாமல் ஓடுவான். அவன் யார்?	படகு
dheivegam_Tamil_riddle_265_75	முட்டையிடும், குஞ்சு பொரிக்காது. கூட்டில் குடியிருக்கும், கூடு கட்டத் தெரியாது. குரலில் இனிமையுண்டு, சங்கீதம் தெரியாது! – அது என்ன?	குயில்
dheivegam_Tamil_riddle_265_76	அழகான பெண்ணுக்கு அதிசயமான வியாதி, பாதிநாள் குறைவாள், பாதிநாள் வளர்வாள் அது என்ன?	நிலா
dheivegam_Tamil_riddle_265_77	பார்க்க அழகு பாம்புக்கு எதிரி அது என்ன?	மயில்
dheivegam_Tamil_riddle_265_78	அக்கா விதைத்த முத்து, அள்ள முடியாத முத்து, அது என்ன?	கோலம்
dheivegam_Tamil_riddle_265_79	ஆயிரம் பேர் அணி வகுத்தாலும் ஆரவாரம் இராது- அவர்கள் யார்?	எறும்புக் கூட்டம்
dheivegam_Tamil_riddle_265_80	எவர் கையிலும் சிக்காத கல் எங்கும் விற்காத கல், அது என்ன?	விக்கல்
dheivegam_Tamil_riddle_265_81	குண்டுச்சட்டியில குதிரை ஓட்டறான்.	கரன்டி
dheivegam_Tamil_riddle_265_82	அடிக்காமல்,திட்டாமல் கண்ணீரை வரவழைப்பாள் அவள் யார்?	வெங்காயம்
dheivegam_Tamil_riddle_265_83	பாலிலே புழு நெளியுது. அது என்ன?	பாயாசம்
dheivegam_Tamil_riddle_265_84	வளைந்து நெளிந்து செல்பவள் வழியெங்கும் தாகம் தீர்ப்பாள் அவள் யார்?	ஆறு
dheivegam_Tamil_riddle_265_85	மேலிலும் துவாரம், கீழிழும் துவாரம், வலதிலும் துவாரம், இடதிலும் துவாரம், உள்ளிலும் துவாரம் வெளியிலும் துவாரம் இருந்தும் நீரை என்னுள் சேமித்து வைப்பேன், நான் யார்?	பஞ்சு
dheivegam_Tamil_riddle_265_86	ஆழக் குழி தோண்டி அதிலே ஒரு முட்டையிட்டு அண்ணாந்து பார்த்தால் தொண்ணூறு முட்டை அது என்ன?	தென்னை
dheivegam_Tamil_riddle_265_87	சங்கீதம் பாடுபவனுக்கு சாப்பாடு இரத்தம் அது என்ன?	கொசு
dheivegam_Tamil_riddle_265_88	மழையில் பிறந்து வெயிலில் காயுது?	காளான்
dheivegam_Tamil_riddle_265_89	அடித்தாலும், உதைத்தாலும் அவன் அழ மாட்டான், அவன் யார்?	பந்து
dheivegam_Tamil_riddle_265_90	வட்ட வட்ட நிலவில் வரைஞ்சிருக்கு; எழுதியிருக்கு. அது என்ன?	நாணயம்
dheivegam_Tamil_riddle_265_91	ஓடையில கருப்பு மீனு துள்ளி விளையாடுது அது என்ன ?	கண்
dheivegam_Tamil_riddle_265_92	பூ பூப்பது கண்ணுக்குத் தெரியும். காய் காய்ப்பது கண்ணுக்குத் தெரியாது. அது என்ன?	வேர்கடலை
dheivegam_Tamil_riddle_265_93	பட்டுப்பை நிறைய பவுண் காசு. அது என்ன?	வத்தல் மிளகாய்
dheivegam_Tamil_riddle_265_94	இருந்த இடத்தில் நகர்ந்தபடி இரவும் பகலும் செல்வான். அவன் யார்?	கடிகாரம்
dheivegam_Tamil_riddle_265_95	உடம்பெல்லாம் பல் கொண்ட ஒருத்திக்கு கடிக்க தெரியாது?	சீப்பு
dheivegam_Tamil_riddle_265_96	காலில் தண்ணீர் குடிப்பான், தலையில் முட்டையிடுவான் அவன் யார்?	தென்னை
dheivegam_Tamil_riddle_265_97	சலசலவென சத்தம் போடுவான், சமயத்தில் தாகம் தீர்ப்பான். அவன் யார்?	அருவி
dheivegam_Tamil_riddle_265_98	கல்லில் காய்க்கும்பூ தண்ணீரில் மலரும்பூ, அது என்ன பூ?	சுண்ணாம்பு
dheivegam_Tamil_riddle_265_99	காற்றைக் குடித்து காற்றில் பறப்பான், அவன் யார்?	பலூன்
dheivegam_Tamil_riddle_265_100	நடந்தவன் நின்றான் கத்தியை எடுத்து தலையைச் சீவினேன் மறுபடியும் நடந்தான் அவன் யார்?	பென்சில்
dheivegam_Tamil_riddle_265_101	எத்தனை தரம் சுற்றினாலும் தலை சுற்றாது, அது என்ன?	மின் விசிறி
dheivegam_Tamil_riddle_265_102	வெள்ளை ராஜாவுக்கு கறுப்பு உடை அது என்ன?	உழுந்து
dheivegam_Tamil_riddle_265_103	முத்துக் கோட்டையிலே மகாராணி சிறைபட்டிருக்கிறாள். அவள் யார்?	நாக்கு
dheivegam_Tamil_riddle_265_104	கூரை வீட்டைப் பிரிச்சா ஓட்டுவீடு! ஓட்டு வீட்டுக்குள்ள வெள்ளை மாளிகை!வெள்ளை மாளிகைக்கு நடுவில் குளம்!அது என்ன?	தேங்காய்
dheivegam_Tamil_riddle_265_105	பேச்சுக் கேட்குது பேசுபவர் தெரியவில்லை. அது என்ன?	வானொலி பெட்டி
dheivegam_Tamil_riddle_265_106	கந்தல் துணிக்காரி முத்துப் பிள்ளைகள் பெற்றாள் அவள் யார்?	சோளப்பொத்தி
dheivegam_Tamil_riddle_265_107	வடிவழகு மாப்பிள்ளை வயிற்றால் நடக்கிறார். அவர் யார்?	பாம்பு
dheivegam_Tamil_riddle_265_108	உடல் சிவப்பு, வாய் அகலம், உணவு காகிதம்- நான் யார்?	அஞ்சல் பெட்டி.
dheivegam_Tamil_riddle_265_109	இது ஒரு பூ. முதற்பகுதி ஆதவனின் மறுபெயர்; பிற்பகுதி தேசத் தந்தையை குறிக்கும். அது என்ன?	சூரிய காந்தி
dheivegam_Tamil_riddle_265_110	பச்சை நிற அழகிக்கு உதட்டுச் சாயம் பூசாமலே சிவந்தவாய் அவள் யார்?	கிளி
dheivegam_Tamil_riddle_265_111	இரவு வீட்டிற்கு வருவான், இரவு முழுவதும் இருப்பான் காலையில் சொல்லாமல் கொள்ளாமல் போய்விட்டிருப்பான்?	நிலா
dheivegam_Tamil_riddle_265_112	ஓடையில் ஓடாத நீர், ஒருவரும் குடிக்காத நீர். அது என்ன?	கண்ணீர்
dheivegam_Tamil_riddle_265_113	அம்மா படுத்திருக்க மகள் ஓடித்திரிவாள் அது என்ன?	அம்மி குளவி
dheivegam_Tamil_riddle_265_114	ஒரு வீட்டுக்கு இரண்டு வாசல்படி. அது என்ன?	மூக்கு
dheivegam_Tamil_riddle_265_115	ஊரெல்லாமல் ஒரே விளக்கு. அதற்கு ஒரு நாள் ஒய்வு அது?	சந்திரன்
dheivegam_Tamil_riddle_265_116	உடம்பெல்லாம் தங்கநிறம், தலையில் பச்சை கிரீடம் அது என்ன?	அன்னாசிப் பழம்
dheivegam_Tamil_riddle_265_117	குண்டுச் சட்டியில் கெண்டை மீன். அது என்ன?	நாக்கு.
dheivegam_Tamil_riddle_265_118	கண்ணீர் விட்டு வெளிச்சம் தருவாள் அவள் யார்?	மெழுகுத்திரிவத்தி
dheivegam_Tamil_riddle_265_119	நன்றிக்கு வால் கோபத்துக்கு வாய் அது என்ன?	நாய்
dheivegam_Tamil_riddle_265_120	பூ கொட்ட கொட்ட ஒன்றையும் தனியே பொறுக்க முடியவில்லை?	மழை
dheivegam_Tamil_riddle_265_121	நீண்ட உடம்புக்காரன், நெடுந்தூரப் பயணக்காரன்?	ரயில்
dheivegam_Tamil_riddle_265_122	எடுக்க எடுக்க வளரும். எண்ணெயைக் கண்டால் படிந்துவிடும். அது என்ன?	முடி
dheivegam_Tamil_riddle_265_123	அரிவாளால் வெட்டி வெட்டி அடுப்பிலே வெச்சாலும் மூச்சே விட மாட்டான். அவன் யார்?	விறகு
dheivegam_Tamil_riddle_265_124	தண்ணியில்லாத காட்டிலே அலைந்து தவிக்கும் அழகி. அவள் யார்?	ஒட்டகம்
dheivegam_Tamil_riddle_265_125	ஆகாரமாக எதையும் தந்தால் சாப்பிடுவேன், ஆனால் நீரை குடிக்க தந்தால் இறந்து விடுவேன், நான் யார்?	நெருப்பு
dheivegam_Tamil_riddle_265_126	ஒன்று போனால் மற்றொன்றும் வாழாது. அது என்ன?	செருப்பு
dheivegam_Tamil_riddle_265_127	ஊரெல்லாம் சுத்துவான், ஆனால் வீட்டிற்குள் வரமாட்டான். அவன் யார்?	செருப்பு
dheivegam_Tamil_riddle_265_128	கருப்பர்கள் மாநாடு போட்ட இடத்தில் கண்ணீர் பிரவாகம். அது என்ன?	மேகம், மழை.
dheivegam_Tamil_riddle_265_129	கூட்டுக்குள் குடியிருக்கும் குருவி அல்ல; கொலை செய்யும்; பாயும்; அது வீரனுமல்ல. அது என்ன?	அம்பு.
dheivegam_Tamil_riddle_265_130	ஆடும் வரை ஆட்டம் , ஆடிய பின் ஓட்டம் அது என்ன?	இதயம்
dheivegam_Tamil_riddle_265_131	தண்ணியில்லாத காட்டிலே அலைந்து தவிக்கும் அழகி. அவள் யார்?	ஒட்டகம்
dheivegam_Tamil_riddle_265_132	ஊசி நுழையாத கிணற்றிலே ஒரு படி தண்ணீர்?	தேங்காய்
dheivegam_Tamil_riddle_265_133	பாலாற்றின் நடுவே கறுப்பு மீன் தெரியுது அது என்ன?	கண்கள்
dheivegam_Tamil_riddle_265_134	முதலெழுத்து தமிழின் அடுத்த எழுத்து கடை மூன்று சேர்ந்தால் ஒரு எண்ணிக்கை மொத்தத்தில் இது வருமுன் எச்சரிக்கை தேவை?	ஆபத்து
dheivegam_Tamil_riddle_265_135	மண்ணுகுளே கிடப்பான் மங்களகரமானவன் அவன் யார்?	மஞ்சள்
dheivegam_Tamil_riddle_265_136	நிலத்தில் முளைக்காத செடி நிமிர்ந்து நிற்காத செடி அது என்ன?	தலை முடி
dheivegam_Tamil_riddle_265_137	குண்டன் குழியில் விழுவான், குச்சியப்பன் தூக்கி விடுவான் – அது என்ன?	பணியாரம்
dheivegam_Tamil_riddle_265_138	எழுதி எழுதியே தேய்ஞ்சு போனான். அவன் யார்?	பென்சில்
dheivegam_Tamil_riddle_265_139	பச்சைபெட்டிக்குள் வெள்ளை முத்துக்கள். அது என்ன?	வெண்டைக்காய்
dheivegam_Tamil_riddle_265_140	நீண்ட உடலிருக்கும் தூணும் அல்ல ,உடலில் சட்டை இருக்கும் ஆனால் உயிர் இல்லை,துயிலில் சுகம் இருக்கும் மெத்தை அல்ல அது என்ன?	தலையணை
dheivegam_Tamil_riddle_265_141	எட்டுக்கால் ஊன்றி இருகால் படமெடுக்க வட்டக் குடைபிடித்து வாறாராம் வன்னியப்பு அது என்ன?	நண்டு
dheivegam_Tamil_riddle_265_142	ஓய்வு எடுக்காமல் இயங்கும். ஓய்வு எடுத்துவிட்டால் மறுபடியும் இயங்காது. அது என்ன?	இதயம்
dheivegam_Tamil_riddle_265_143	நான் இருந்ததில்லை ஆனாலும் இருப்பவனாக இருப்பேன். என்னை யாரும் பார்த்ததில்லை பார்க்கும் முன் பழசாயிருப்பேன். என்னை நம்பியே இந்த உலகமும் ,மக்களும் நல்லது நடக்குமென எண்ணுகிறார்கள் நான் யார்?	நாளை
dheivegam_Tamil_riddle_265_144	கிட்ட இருக்கும் பட்டணம்; எட்டித்தான் பார்க்க முடியவிலை. அது என்ன?	முதுகு.
dheivegam_Tamil_riddle_265_145	கோவிலைச் சுற்றிக் கருப்பு; கோவிலுக்குள்ளே வெளுப்பு. அது என்ன?	சோற்றுப்பானை-சோறு.
dheivegam_Tamil_riddle_265_146	வெள்ளை ஆளுக்கு கறுப்புத் தலைப்பாகை. அது என்ன?	தீக்குச்சி
dheivegam_Tamil_riddle_265_147	அரைசாண் ராணிக்கு வயிற்றில் ஆயிரம் முத்துகள். அது என்ன?	வெண்டைக்காய்
dheivegam_Tamil_riddle_265_148	அழுவேன்,சிரிப்பேன் அனைத்தும் செய்வேன் நான் யார்?	முகம் பார்க்கும் கண்ணாடி
dheivegam_Tamil_riddle_265_149	முதுகிலே சுமை தூக்கி முனகாமல் அசைந்து வரும் அது என்ன?	நத்தை
dheivegam_Tamil_riddle_265_150	அம்மா போடும் வட்டம், பளபளக்கும் வட்டம், சுவையைக் கூட்டும் வட்டம். சுட்டுத் தின்ன இஸ்டம். அது என்ன?	அப்பளம்
dheivegam_Tamil_riddle_265_151	தொப்பொன்று விழுந்தான் தொப்பி கழன்றான் அவன் யார்?	பனம்பழம்
dheivegam_Tamil_riddle_265_152	முயல் புகாத காடு எது?	முக்காடு
dheivegam_Tamil_riddle_265_153	உயரத்தில் இருப்பிடம்.தாகம் தீர்ப்பதில் தனியிடம் அது என்ன?	இளநீர்
dheivegam_Tamil_riddle_265_154	தலையைச் சீவினால் தாளில் நடப்பான் அவன் யார்?	பென்சில்
dheivegam_Tamil_riddle_265_155	கண்டு பிடித்தவனும் வைத்திருக்கவில்லை, வாங்கியவனும் உபயோகிக்கவில்லை, உபயோகிப்பவனுக்கு அதனை பற்றி எதுவும் தெரியாது அது என்ன?	சவப்பெட்டி
dheivegam_Tamil_riddle_265_156	மழை காலத்தில் குடை பிடிப்பான், மனிதனல்ல. அவன் யார்?	காளான்
dheivegam_Tamil_riddle_265_157	ஒரு குற்றத்தை செய்ய முயற்சித்தால் தண்டனை உண்டு, ஆனால் குற்றத்தை செய்தால் தண்டிக்க முடியாது, அக் குற்றம் என்ன?	தற்கொலை
dheivegam_Tamil_riddle_265_158	எப்போதும் காதருகில் ரகசியம் பேசிக் கொண்டிருப்பவள், அவள் யார்?	செல்போன்
dheivegam_Tamil_riddle_265_159	ஓவென்று உயர்ந்த மலை, நடுவே உடன் பிறப்பு இருவர் ! ஒருவரை மற்றவர் பார்ப்பதுமில்லை; பேசுவதும் இல்லை. அவர்கள் யார்?	கண், மூக்கு.
dheivegam_Tamil_riddle_265_160	மீன் பிடிக்கத் தெரியாதாம் ஆனால் வலை பின்னுவானாம் அவன் யார்?	சிலந்தி
dheivegam_Tamil_riddle_265_161	தொட்டுப் பார்க்கலாம் எட்டிப் பார்க்கமுடியாது அது என்ன?	முதுகு
dheivegam_Tamil_riddle_265_162	வீட்டிலிருப்பான் காவலாலி, வெளியில் சுற்றுவான் அவன் கூட்டாளி, அவர்கள் யார்?	பூட்டும் திறப்பும்
dheivegam_Tamil_riddle_265_163	கொம்பு நிறைய கம்பு அது என்ன ?	மாதுளம்பழம்
dheivegam_Tamil_riddle_265_164	காட்டிலே பச்சை; கடையிலே கறுப்பு; வீட்டிலே சிவப்பு. அது என்ன?	மரம்-கரி-நெருப்பு.
dheivegam_Tamil_riddle_265_165	என்னைத் தெரியாத போது தெரிந்து கொள்ளும் ஆவல்.தெரிந்த பிறகு பகிர்ந்து கொள்ளும் ஆசை. நான் மறைக்கப்பட வேண்டியவன். நான் யார்?	இரகசியம்
dheivegam_Tamil_riddle_265_166	நடக்கவும் மாட்டேன், நகராமல் இருக்கவும் மாட்டேன் நான் யார்?	மணிக்கூடு
dheivegam_Tamil_riddle_265_167	மழையோடு வருகின்ற மஞ்சள் புறாவை வெட்டினால் ஒரு சொட்டு இரத்தம் வராது. அது என்ன?	ஈசல்
dheivegam_Tamil_riddle_265_168	நடந்தவன் நின்றான். கத்தியை எடுத்து தலையைச் சீவினேன். மறுபடி நடந்தான். அவன் யார்?	பென்சில்
dheivegam_Tamil_riddle_265_169	விரல் இல்லாமலே ஒரு கை. அது என்ன?	தும்பிக்கை
dheivegam_Tamil_riddle_265_170	வெள்ளத்தில் போகாது, வெந்தணலில் வேகாது. கொள்ளையடிக்க முடியாது, கொடுத்தாலும் குறையாது. அது என்ன?	கல்வி
dheivegam_Tamil_riddle_265_171	அம்மா பின்னிய நூலை அவிழ்த்தால் போச்சு. அது என்ன?	இடியாப்பம்
dheivegam_Tamil_riddle_265_172	தண்ணீரில் மிதக்குது கட்டழகிய வீடுகள் -அது என்ன?	கப்பல்கள்
dheivegam_Tamil_riddle_265_173	தொட்டால் மணக்கும், சுவைத்தால் புளிக்கும். அது என்ன?	எழுமிச்சம்பழம்
dheivegam_Tamil_riddle_265_174	இதயம் போல் துடிப்பிருக்கும், இரவு பகல் விழித்திருக்கும். அது என்ன?	கடிகாரம்
dheivegam_Tamil_riddle_265_175	உணவு கொடுத்தால் வளரும்; நீர் கொடுத்தால் அழியும். அது என்ன?	நெருப்பு
dheivegam_Tamil_riddle_265_176	ஊசி போல் இருப்பான், ஊரையே எரிப்பான். அது என்ன?	தீக்குச்சி
dheivegam_Tamil_riddle_265_177	கத்தி போல் இலை இருக்கும் கவரிமான் பூ பூக்கும் தின்ன பழம் கொடுக்கும் தின்னாத காய் கொடுக்கும் அது என்ன?	வேம்பு
dheivegam_Tamil_riddle_265_178	எண்ணெய் வேண்டா விளக்கு; எடுப்பான் கை விளக்கு. அது என்ன?	மெழுகுவர்த்தி
dheivegam_Tamil_riddle_265_179	அத்துவான காட்டிலே பச்சைப்பாம்பு தொங்குது – அது என்ன?	புடலங்காய்
dheivegam_Tamil_riddle_265_180	மரத்திற்கு மேலே பழம், பழத்திற்கு மேலே மரம் அது என்ன?	அன்னாசிப்பழம்
dheivegam_Tamil_riddle_265_181	ஊருக்கெல்லாம் ஓய்வு, உழைப்பவர்க்கும் ஓய்வு; இவனுக்கு மட்டும் ஓய்வில்லை; இரவும் பகலும் ஓட்டந்தான். அது என்ன?	மூச்சு
dheivegam_Tamil_riddle_265_182	சட்டையைக் கழற்றியதும் சடக்கென்று உள்ளே விழும் – அது என்ன?	வாழைப்பழம்
dheivegam_Tamil_riddle_265_183	அச்சு இல்லாத சக்கரம், அழகு காட்டும் சக்கரம். அது என்ன?	வளையல்
dheivegam_Tamil_riddle_265_184	வானத்தில் பறக்கும் பறவை இது, ஊரையே சுமக்கும் பறவை இது அது என்ன?	விமானம்
dheivegam_Tamil_riddle_265_185	ஒட்டியவன் ஒருத்தன், பிரித்தவன் இன்னொருவன். அது என்ன?	கடிதம்
dheivegam_Tamil_riddle_265_186	உருவத்தில் சிறியவன். உழைப்பில் பெரியவன். அவன் யார்?	எறும்பு
dheivegam_Tamil_riddle_265_187	நான் சூரியனைக் கடந்து சென்றால் கூட எனக்கு நிழல் ஏற்படாது. நான் யார்?	தென்றல்
dheivegam_Tamil_riddle_265_188	வெயிலில் மலரும், காற்றில் உலரும். அது என்ன?	வியர்வை
dheivegam_Tamil_riddle_265_189	காற்று இல்லாத கண்ணாடிக் கூண்டில் மஞ்சக் கோழி மயங்கி கிடக்குது அது என்ன?	முட்டை
dheivegam_Tamil_riddle_265_190	காலையில் ஊதும் சங்கு, கறி சமைக்க உதவும் சங்கு அது என்ன?	சேவல்
dheivegam_Tamil_riddle_265_191	அள்ளவும் முடியாது, கிள்ளவும் முடியாது. அது என்ன?	காற்று
dheivegam_Tamil_riddle_265_192	குண்டு குள்ளனுக்கு குடுமி நிமிர்ந்தே இருக்கும் அவன் யார்?	கத்தரிக்காய்
dheivegam_Tamil_riddle_265_193	அந்தரத்தில் தொங்குவது சொம்பும் தண்ணீரும் – அது என்ன?	இளநீர்
dheivegam_Tamil_riddle_265_194	எட்டாத ராணியாம் இரவில் வருவாள், பகலில் மறைவாள். அது யார்?	நிலா
dheivegam_Tamil_riddle_265_195	ஆள் இறங்காத குளத்தில் ஆடி இறங்கி கூத்தாடுது. அது என்ன ?	மத்து
dheivegam_Tamil_riddle_265_196	கண்ணில் தென்படுவான், கையில் பிடிபட மாட்டான். அவன் யார்?	புகை
dheivegam_Tamil_riddle_265_197	அடித்து நொறுக்கி அணலில் போட்டால் ஆவியாகத் தோன்றி அழகாய் மணக்கும். அது என்ன?	சாம்பிராணி
dheivegam_Tamil_riddle_265_198	தலை இல்லாதவன் தலையை சுமப்பவன். அவன் யார் ?	தலையணை
dheivegam_Tamil_riddle_265_199	நாலு மூளைக்கிணறு, நாகரத்தினக்கிணறு, எட்டிப் பார்த்தால் சொட்டுத தண்ணீர் இல்லை அது என்ன?	அச்சு வெல்லம்
dheivegam_Tamil_riddle_265_200	வாலால் நீர் குடிக்கும்,வயால் பூச்சொரியும் அது என்ன?	விளக்கு
dheivegam_Tamil_riddle_265_201	அடிமேல் அடி வாங்கி அனைவரையும் சொக்க வைக்கும். அது என்ன?	மிருதங்கம்
dheivegam_Tamil_riddle_265_202	கை பட்டால் சிணுங்கும் கன்னிப் பெண், கூச்சல் போட்டு கதவை திறக்க வைப்பவள் அவள் யார்?	கா‌லி‌ங்பெ‌ல்
dheivegam_Tamil_riddle_265_203	பகலிலே வெறுங்காடு, இரவெல்லாம் பூக்காடு. அது என்ன?	வானம்
dheivegam_Tamil_riddle_265_204	ஓட்டம் நின்றால் போதும் ஆட்டம் நின்று போகும். அது என்ன?	ரத்தம்
dheivegam_Tamil_riddle_265_205	கறுப்புக் காகம் ஓடிப்போச்சு, வெள்ளைக் காகம் நிற்குது. அது என்ன?	உளுந்து
dheivegam_Tamil_riddle_265_206	மணம் இல்லாத மல்லிகை மாலையில் மலரும் அது என்ன?	தீபம்
dheivegam_Tamil_riddle_265_207	காலில்லா பந்தலைக் காணக் காண சந்தோஷம் அது என்ன?	வானம்
dheivegam_Tamil_riddle_265_208	உரசினால் உயிரே மாய்த்துக் கொள்ளும் அது என்ன?	தீ‌க்கு‌ச்‌சி
dheivegam_Tamil_riddle_265_209	ஆறு எழுத்துள்ள ஓர் உலோகப் பெயர். அதன் கடை மூன்று எழுத்துகள் சேர்ந்தால் ஒரு கொடிய பிராணி. அது என்ன?	துத்தநாகம்
dheivegam_Tamil_riddle_265_210	வந்தும் கெடுக்கும், வராமலும் கெடுக்கும். அது என்ன?	மழை
dheivegam_Tamil_riddle_265_211	மண்ணுக்குள் இருக்கும், மங்கைக்கு அழகு தரும் அது என்ன?	மஞ்சள்
dheivegam_Tamil_riddle_265_212	காளைக்குக் கழுத்து மட்டும் தண்ணீர் அது என்ன?	தவளை
dheivegam_Tamil_riddle_265_213	ஏரியில் இல்லாத நீர்,தாகத்திற்கு உதவாத நீர், தண்ணீர் அல்ல அது என்ன?	கண்ணீர்
dheivegam_Tamil_riddle_265_214	நான் வெட்டுப்பட்டால், வெட்டியவனை அழ வைப்பேன் நான் யார்?	வெங்காயம்
dheivegam_Tamil_riddle_265_215	தண்ணீரில் பிறப்பான்; தண்ணீரில் இறப்பான். அவன் யார்?	உப்பு
dheivegam_Tamil_riddle_265_216	சின்னப்பயல் உரசினால் சீறிப் பாய்வான் – அது என்ன?	தீக்குச்சி
dheivegam_Tamil_riddle_265_217	நடலாம், பிடுங்க முடியாது அது என்ன?	பச்சை குத்துதல்
dheivegam_Tamil_riddle_265_218	ஆயிரம் பேர் அணிவகுத்தாலும் ஒரு தூசி கிளம்பாது. அவை யாவை?	எறும்புகள்
dheivegam_Tamil_riddle_265_219	ஏற்றி வைத்து அணைத்தால் எரியும் வரை மணக்கும் அது என்ன?	ஊதுபத்தி
dheivegam_Tamil_riddle_265_220	கல்லுக்கும் முள்ளுக்கும் அஞ்சாதவன், பள்ளநீரைக் கண்டு பதைபதைக்கிறான். அது என்ன?	நெருப்பு
dheivegam_Tamil_riddle_265_221	தாழ்ப்பாள் இல்லாத கதவு, தானாக மூடி திறக்கும் கதவு அது என்ன?	க‌ண் இமை
dheivegam_Tamil_riddle_265_222	காலடியில் சுருண்டிருப்பாள்; கணீர் என்று குரலிசைப்பாள். அவள் யார் ?	மெட்டி
dheivegam_Tamil_riddle_265_223	வித்தில்லாமல் விளையும்; வெட்டாமல் சாயும். அது என்ன?	வாழை
dheivegam_Tamil_riddle_265_224	அடர்ந்த காட்டின் நடுவே ஒரு பாதை – அது என்ன ?	தலை வகிடு
dheivegam_Tamil_riddle_265_225	வண்ணப் பட்டுச் சேலைக்காரி, நீல வண்ண ரவிக்கைக் காரி அது என்ன?	மயில்
dheivegam_Tamil_riddle_265_226	அறிவின் மறுபெயர், இரவில் வருவது. அது என்ன?	மதி
dheivegam_Tamil_riddle_265_227	வேகாத வெயிலில் வெள்ளையப்பன் விளைகிறான். அது என்ன?	உப்பு
dheivegam_Tamil_riddle_265_228	வெட்டிக்கொள்வான் ஆனாலும் ஒட்டிக்கொள்வான் அவன் யார்?	கத்தரிக்கோல்
dheivegam_Tamil_riddle_265_229	தலையை சீவினால் தாகம் தீர்ப்பான்.அவன் யார்?	இள‌நீ‌ர்
dheivegam_Tamil_riddle_265_230	ஒற்றைக்கால் மனிதனுக்கு ஒன்பது கை. அது என்ன?	மரம்
dheivegam_Tamil_riddle_265_231	காவி உடையணியாத கள்ளத்தவசி கரையோரம் கடுந்தவம் செய்கிறான் அவன் யார்?	கொக்கு
dheivegam_Tamil_riddle_265_232	உடல் கொண்டு குத்திடுவான்; உதிரிகளை ஒன்றிணைப்பான். அது என்ன ?	ஊசி
dheivegam_Tamil_riddle_265_233	காலாறும் கப்பற்கால் கண்ணிரண்டும் கீரை விதை. அது என்ன?	ஈ
dheivegam_Tamil_riddle_265_234	ஓடியாடி வேலை செய்தபின் மூலையில் ஒதுங்கிக்கிடப்பாள் அவள் யார்?	துடைப்பம்
dheivegam_Tamil_riddle_265_235	கோடையிலே ஆடி வரும் வாடையில முடங்கி விடும் – அது என்ன?	மின்விசிறி
dheivegam_Tamil_riddle_265_236	நடைக்கு உவமை, நளனக்கு தூதுவன் அவன் யார்?	அன்னம்
dheivegam_Tamil_riddle_265_237	கூட்டுச் சேர்ந்து கோட்டைக் கட்டும்; மாட்டுவோரை மடக்கித் தாக்கும். அது என்ன?	தேனீ
dheivegam_Tamil_riddle_265_238	ஆயிரம் பேர் வந்து சென்றாலும் வந்த சுவடு தெரியாது? அது என்ன?	எறு‌ம்பு
dheivegam_Tamil_riddle_265_239	வளைஞ்சு நெளிஞ்சு ஆடும் தண்ணீர் குடித்தால் சாகும் அது என்ன?	நெருப்பு
dheivegam_Tamil_riddle_265_240	தணித்து உண்ணமுடியாது என்றாலும் இது சேர்த்தால்தான் உணவுக்கு சுவை அது என்ன?	உப்பு
dheivegam_Tamil_riddle_265_241	கலர்ப்பூ கொண்டைக்காரி, காலையில் எழுப்பிவிடுவாள். அது என்ன?	சேவல்
dheivegam_Tamil_riddle_265_242	சொன்னதைச் சொல்லும் பொண்ணுக்கு, பச்சைப் பாவாடை கேட்குதாம் அது என்ன?	கிளி
dheivegam_Tamil_riddle_265_243	தண்ணீர் இல்லாமல் வளரும்; தரை இல்லாமல் படரும். அது என்ன?	உரோமம்
dheivegam_Tamil_riddle_265_244	காலில்லாதவன் வளைவான், நெளிவான் காடு மேடெல்லாம் அலைவான் அவன் யார்?	பாம்பு
dheivegam_Tamil_riddle_265_245	பல அடுக்கு மாளிகையில் இனிப்பு விருந்து. அது என்ன?	தேன்
dheivegam_Tamil_riddle_265_246	சிவப்பான பெட்டிக்குள் கருகு மணி முத்துக்கள் அது என்ன?	பப்பாளி விதைகள்
dheivegam_Tamil_riddle_265_247	காலையிலே கூவும் பட்சி, கந்தன் கொடியில் காணும் பட்சி, குப்பையைக் கிளறும் பட்சி, கொண்டையுடைய பட்சி – அது என்ன?	சேவல்
dheivegam_Tamil_riddle_265_248	அடிக்காத பிள்ளை அலறித் துடிக்குது. அது என்ன?	சங்கு
dheivegam_Tamil_riddle_265_249	ஒற்றைக்கால் குள்ளனுக்கு எட்டுக் கை. அது என்ன?	குடை
dheivegam_Tamil_riddle_265_250	காற்று நுழைந்ததும் கானம் பாடுகிறான். அவன் யார்?	புல்லாங்குழல்
dheivegam_Tamil_riddle_265_251	அனைவரையும் நடுங்க வைப்பான், ஆதவனுக்கே அடங்குவான். அது என்ன?	குளிர்
dheivegam_Tamil_riddle_265_252	சுற்றும்போது மட்டும் சுகம் தருவாள். அது என்ன?	மின்விசிறி
dheivegam_Tamil_riddle_265_253	அடி மலர்ந்து நுனி மலராத பூ – அது என்ன ?	வாழைப்பூ
dheivegam_Tamil_riddle_265_254	ஆயிரம் தச்சர் கூடி கட்டிய அந்த அழகான மண்டபம் , ஒருவர் கண்பட்டு உடைந்ததாம் அந்த மண்டபம். அது என்ன?	தேன் கூடு
dheivegam_Tamil_riddle_265_255	பேசாத வரை நான் இருப்பேன். பேசினால் நான் உடைந்துவிடுவேன். நான் யார்?	அமைதி
dheivegam_Tamil_riddle_265_256	அடித்தால் விலகாது, அணைத்தால் நிற்காது. அது என்ன?	தண்ணீர்
dheivegam_Tamil_riddle_265_257	நடக்கத் தெரியாதவன், நட்டுவனுக்கு வழி காட்டுகிறான் அவன் யார்?	கைகாட்டி
dheivegam_Tamil_riddle_265_258	தலையில் கீரீடம் வைத்த தங்கப்பழம் அது என்ன?	அன்னாசிப்பழம்
dheivegam_Tamil_riddle_265_259	ராஜா, ராணி உண்டு நாடு அல்ல. இலைகள் பல உண்டு, தாவரம் இல்லை! அது என்ன?	காட்ஸ்
dheivegam_Tamil_riddle_265_260	கந்தல் துணிக்காறி முத்துப் பிள்ளைகள் பெற்றாள் அவள் யார்?	சோளப்பொத்தி
dheivegam_Tamil_riddle_265_261	மூன்றெழுத்துப் பெயராகும். முற்றும் வெள்ளை நிறமாகும் அது என்ன?	பஞ்சு
dheivegam_Tamil_riddle_265_262	கழுத்து உண்டு, தலையில்லை; உடல் உண்டு, உயிர் இல்லை, கையுண்டு, விரல் இல்லை. அது என்ன?	சட்டை
dheivegam_Tamil_riddle_265_263	கோணல் எத்தனை இருந்தாலும் குணமும் குறியும் மாறாது – அது என்ன?	கரும்பு
dheivegam_Tamil_riddle_265_264	மணல் வெளியில் ஓடுது, தண்ணீர் கேட்காத கப்பல் அது என்ன?	ஒட்டகம்
dheivegam_Tamil_riddle_265_265	பேசுவான் நடக்கமாட்டான்; பாடுவான் ஆடமாட்டான். அவன் யார் ?	வானொலிப் பெட்டி
dheivegam_Tamil_riddle_265_266	சங்கீதம் பாடும் சல்லாபம் செய்யும் சமயத்தில் ரத்தம் குடிக்கும் – அது என்ன?	கொசு
dheivegam_Tamil_riddle_265_267	நான்தான் சகலமும். என்னைப் பார்க்க முடியாது, பிடிக்கவும் முடியாது. எனக்கு வாயில்லை, ஆனால் நான் ஓசை எழுப்புவேன். நான் யார் ?	காற்று
dheivegam_Tamil_riddle_265_268	கோயிலுக்குப் போனானாம் எங்க தம்பி தீர்த்தம் விட்டானாம் தங்கத் தம்பி – அது என்ன?	தேங்காய்
dheivegam_Tamil_riddle_265_269	முழு உலகமும் சுற்றி வரும், ஆனால் ஒரு மூலையிலேயே இருக்கும் அது என்ன?	அஞ்சல் தலை
dheivegam_Tamil_riddle_265_270	அண்டமென்ற பெயரும் உண்டு, அடைகாத்தால் குஞ்சுமுண்டு. அது என்ன?	முட்டை
dheivegam_Tamil_riddle_265_271	ஒற்றைக் காலில் ஆடுவான், ஓய்ந்து போனால் படுப்பான். அவன் யார்?	பம்பரம்
dheivegam_Tamil_riddle_265_272	காலைக்கடிக்கும் செருப்பல்ல, காவல் காக்கும் நாயல்ல அது என்ன?	முள்
dheivegam_Tamil_riddle_265_273	ஆகாயத்தில் பறக்கும். அக்கம் பக்கம் போகாது. அது என்ன?	கொடி
dheivegam_Tamil_riddle_265_274	பிறந்தது முதல் வயிற்றாலே போகிறது. அது என்ன?	பாம்பு
dheivegam_Tamil_riddle_265_275	ஒளி கொடுக்கும், விளக்கு அல்ல; சூடு கொடுக்கும், தீ அல்ல; பளபளக்கும், தங்கம் அல்ல. அது என்ன?	சூரியன்
dheivegam_Tamil_riddle_265_276	பொட்டுப்போல் இலை இருக்கும், பொரிபோல் பூப் பூக்கும், தின்னக்காய் காய்க்கும், தின்னாப் பழம் பழுக்கும் அது என்ன?	முருங்கைமரம்
dheivegam_Tamil_riddle_265_277	என்னைப் பார்க்க முடியும், ஆனால் எனக்கு எடை கிடையாது. என்னை ஒரு பாத்திரத்தில் போட்டால் அதன் அளவை குறைத்திடுவேன். நான் யார்?	துவாரம்
dheivegam_Tamil_riddle_265_278	தொட்டு விட்டால் மூடிக் கொள்ளும் பச்சை மாளிகை ஜன்னல்கள் அது என்ன?	தொட்டா சுருங்கிச் செடி
dheivegam_Tamil_riddle_265_279	அந்திவரும் நேரம், அவளும் வரும் நேரும் அது என்ன?	நிலா
dheivegam_Tamil_riddle_265_280	பூமியிலே பிறக்கும், புகையாய்ப் போகும். அது என்ன?	பெட்ரோல்
dheivegam_Tamil_riddle_265_281	இரவும் பகலும் ஓய்வு இல்லை, படுத்தால் எழுப்ப ஆள் இல்லை அது என்ன?	இதயம்
freshtamil_1	படுத்துத்தூங்கினால் கண்முன் ஆடும்; அடுத்து விழித்தால் மறைந்தே ஓடும்.	கனவு
freshtamil_2	ஒற்றைக்காலில் காலில் சுற்றுவான் ஓய்ந்து போனால் படுத்து விடுவான்	பம்பரம்
freshtamil_3	கடிவாளம் போட்டால் காலிலே கிடக்கும்.	செருப்பு
freshtamil_4	ஒரு பானைச் சோறு வடித்து, ஓராயிரம் பேருக்குப் போட்டு, இன்னும்கூட மிச்சமிருக்கு.	சுண்ணாம்பு
freshtamil_5	மடக்காமல் பறக்குதே, அது என்ன மந்திரி ? சிமிட்டாமல் விழிக்குதே, அதுதான் அரசே.	தட்டாரப் பூச்சி
freshtamil_6	ஒல்லியான மனிதன் ; ஒரே காது மனிதன், அவன் காது போனால், ஏது பயன்?	ஊசி
freshtamil_7	நீரிலே கொண்டாட்டம்; நிலத்திலே திண்டாட்டம்	மீன்
freshtamil_8	சின்னஞ் சிறு வீட்டில் சிப்பாய்கள் பல பேர்	தீக்குச்சி
freshtamil_9	கோயிலைச் சுற்றிக் கறுப்பு; கோயிலுக்குள்ளே வெளுப்பு	சோற்றுப் பானை
freshtamil_10	பச்சைக் கதவு, வெள்ளை ஜன்னல், கறுப்பு ராஜா.	சீத்தாப்பழம்
freshtamil_11	நடக்க முடியாது: ஆனால் நகராமல் இருக்காது. அது என்ன?	கடிகாரம்
freshtamil_12	முதுகை அமுக்கினால் மூச்சு விடுவான் பல்லை அழுத்தினால் பாட்டுப் பாடுவேன்	ஆர்மோனியம்
freshtamil_13	அழகான பெண்ணுக்கு அதிசயமான வியாதி. பாதி நாள் குறைவாள், பாதிநாள் வளர்வாள்.	நிலா
freshtamil_14	ஏணிமேலே கோணி; கோணி மேலே குழாய்; குழாய் மேலே குண்டு; குண்டு மேலே புல்லு; புல்லு மேலே பூச்சி.	மனிதனின் கால், வயிறு, கழுத்து, தலை, மயிர், பேன்
freshtamil_15	மொட்டைப் பாட்டிக்கு, முழுகத் தெரியாது.	வெண்ணெய்
freshtamil_16	ஐந்து அடுக்கு; நாலு இடுக்கு	விரல்கள்
freshtamil_17	கிணற்றைச் சுற்றிப் புல்.	கண் புருவம்
freshtamil_18	சாண் உயரப் பையன், வைத்ததெல்லாம் சுமப்பான்.	அடுப்பு
freshtamil_19	பட்டணத்தில் இருந்து இரண்டு சிராய் கொண்டு வந்தேன். ஒன்று எரியுது; இன்னொன்று புகையுது .	சூடம், சாம்பிராணி
freshtamil_20	அக்கா சப்பாணி. தங்கை நாட்டியக்காரி.	உரல், உலக்கை 
freshtamil_21	அரைச் சாண் குள்ளனுக்குக் கால் சாண் தொப்பி.	பேனா
freshtamil_22	உயிரில்லை ; ஊருக்குப் போவான். காலில்லை; வீட்டுக்கு வருவேன் வாயில்லை ; வார்த்தைகள் சொல்வான்.	கடிதம்
freshtamil_23	நிலத்தை நோக்கி வருவான்; நுரையைக் கக்கிச் செல்வான்.	கடல் அலை
freshtamil_24	அன்னதான மண்டபத்தில் அழகான குருவி. அழகான குருவிக்கு முழம் நீளம் வால்!	அகப்பை 
freshtamil_25	என் தாயோ கடல்; தந்தையோ சூரியன்; என்னை விரும்பாத விடே இல்லை.	உப்பு
freshtamil_26	தம்பிக்கு எட்டும்; அண்ணனுக்கு எட்டாது.	உதடு, தம்பி என்று சொல்லும் போது கீழ் உதடு மேல் உதட்டை தொடும். அண்ணன் என்னும்போது தொடாது
freshtamil_27	அறைகள் அறுநூறு; அத்தனையும் ஓர் அளவு.	தேன் கூடு
freshtamil_28	உருவம் இல்லாதவன்; சொன்னதைத் திருப்பிச் சொல்வான்.	எதிரொலி
freshtamil_29	குளித்தால் கறுப்பு; குளிக்காவிட்டால் சிவப்பு.	நெருப்பு
freshtamil_30	நட்டமாய் நிற்கிறவனுக்கு நறுக்கு நறுக்கென்று கடிக்கிற வேலை.	அரிவாள்மனை
freshtamil_31	தாய் இனிப்பாள்; மகள் புளிப்பாள்; பேத்தி மணப்பாள்.	பால், மோர், நெய்
freshtamil_32	உண்டதை நினைப்பான், உதையை மறப்பான், உயிரையும் கொடுப்பான், வழியும் நடப்பான்.	நாய்
freshtamil_33	காலையில் ஊதும் சங்கு; கறி சமைக்க உதவும் சங்கு.	சேவல்
freshtamil_34	கறுப்புச் சட்டைக்காரன்; காவலுக்குக் கெட்டிக்காரன்.	பூட்டு 
freshtamil_35	தொட்டால் மணக்கும்; குடித்தால் புளிக்கும்.	எலுமிச்சம்பழம்
freshtamil_36	நடக்கத் தெரியாதவன் நடப்பவனுக்கு வழி காட்டுகிறான்.	கைகாட்டி
freshtamil_37	ஏரிக்கரை உயர்ந்திருக்கும், எட்டிப் பழம் சிவந்திருக்கும், காகம் கறுத்திருக்கும், காக்கைக் குஞ்சு வெளுத்திருக்கும்.	அடுப்பு, நெருப்பு, கரி, சோறு
freshtamil_38	இரவிலே பிறந்த இளவரசனுக்குத் தலையிலே குடை.	காளான்
freshtamil_39	உலர்ந்த கொம்பிலே விரிந்த பூ – அது என்ன?	குடை
freshtamil_40	ஈரப் புடவைக்காரி இருபத்தெட்டுச் சுற்றுக்காரி.	வெங்காயம்
freshtamil_41	ஆகாயத்திலிருக்கும் அற்புத மனிதன் ஆற்றிலும் விழுவான்; குளத்திலும் விழுவான்; ஆனால் நனைய மாட்டேன்	சூரியன்
freshtamil_42	வெட்ட வெட்டத் தழைக்கும் பட்டணத்து வேம்பு, அது என்ன?	தலைமுடி
freshtamil_43	சூரியன் காணாத கங்கை ; சுண்ணம் தோற்கும் வெள்ளை; மண்ணிற் பண்ணாத பாண்டம்.	தேங்காய்
freshtamil_44	பறிக்கப் பறிக்க பெரிதாகும் அது என்ன?	குழி
freshtamil_45	வட்ட வட்டச் சிமிழில் இட்டதெல்லாம் குட்டிப் பாம்பு.	இடியாப்பம்
freshtamil_46	தேய்க்கத் தேய்க்க நுரைக்கும் அடிக்க அடிக்க வெளுக்கும்.	சோப்பு
freshtamil_47	எட்டாத கொம்பில் மிட்டாய்ப் பொட்டலம்.	தேன் கூடு
freshtamil_48	மொட்டை மாடு உட்கார்ந்திருக்கிறது மூக்கணாங்கயிறு மேய்ந்து வருகுது.	பூசணிக்காயும் அதன் கொடியும்
freshtamil_49	வராதிருந்து வந்தேன்; வந்துவிட்டுப் போனேன்; போன பிறகு வந்தேன்; இனிப் போனால் வரமாட்டேன். நான் யார் ?	பல்
freshtamil2_temp1_1	முள்ளுக்குள்ளே முத்துக்குவலம் அது என்ன?	பலாப்பழம்
freshtamil2_temp1_2	முக்கண்ணன் சந்தைக்குப்போகின்றான அவன் யார் ?	தேங்காய்
freshtamil2_temp1_3	பட்டுப்பை நிறைய பவுன் காசு அது என்ன ?	மிளகாய்
freshtamil2_temp1_4	தலையைச் சீவினால் தாளிலே மேய்வான் அவன் யார்?	பென்சில்
freshtamil2_temp1_5	வெள்ளை மாளிகையில் மஞ்சள் புதையல் அது என்ன ?	முட்டை
freshtamil2_temp1_6	ஒருவனுக்கு உணவளித் தால் ஊரையே கூட்டுவான். அவன் யார் ?	காகம்
freshtamil2_temp1_7	உடல் சிவப்பு, வாய் அகலம் உணவு காகிதம் நான் யார்?	அஞ்சல் பெட்டி
freshtamil2_temp1_8	விழுந்தால் படுக்காது எழுந்தால் நிற்காது. அது என்ன?	தலையாட்டி பொம்மை
freshtamil2_temp1_9	யாரும் ஏற முடியாத மரம். கிளைகள் இல்லாத மரம். அது என்ன மரம்?	வாழை
freshtamil2_temp1_10	கோணலாக இருந்தாலும் குணமும்சுவையும் குன்றாது. அது என்ன?	கரும்பு
freshtamil2_temp1_11	விட்டம் போட்டு வீடு கட்டியும் விசிறி மாட்ட இடம் இல்லை. அது என்ன?	மூக்கு
freshtamil2_temp1_12	பொட்டுப் போல் இலை இருக்கும் குச்சிபோல காய் காய்க்கும்.அது என்ன?	முருங்கை
freshtamil2_temp1_13	ஆயிரம் அறைகள் கொண் பிரம்மாண்டமான மிட்டாய்க்கடை. அது என்ன?	தேன் கூடு
freshtamil2_temp1_14	மூன்று பெண்களுக்கும் ஒரே முகம்…மூத்தப் பெண் ஆற்றிலே, நடுப் பெண் காட்டிலே, கடைசிப் பெண் வீட்டிலே! அவர்கள் யார்?	முதலை, உடும்பு, பல்லி.
freshtamil2_temp1_15	கூட்டுக்குள்ளே குடியிருக்கும் குருவியும் அல்ல. பாய்ந்து செல்லும் புலியும் அல்ல. எதிரியை கொல்லும் வீரனும் அல்ல அது என்ன?	அம்பு
freshtamil2_temp1_16	அள்ளவும் முடியாது; கிள்ளவும் முடியாது – அது என்ன?	காற்று
freshtamil2_temp1_17	ஆலமரம் தூங்க, அவனியெல்லாம் தூங்க, சீரங்கம் தூங்க, திருப்பாற்கடல் தூங்க, ஒருவன் மட்டும் தூங்கவில்லை – அது என்ன?	மூக்கு
freshtamil2_temp1_18	ஆள் இறங்காத கிணற்றிலே மரம் இறங்கிக் கூத்தாடுது – அது என்ன?	தயிர் கடையும் மத்து.
freshtamil2_temp1_19	உச்சிக் கிளையிலே ஒரு முழக் குச்சி ஊசலாடுது – அது என்ன?	முருங்கைக்காய்.
freshtamil2_temp1_20	உலகுக்கெல்லாம் ஒரே துப்பட்டி – அது என்ன?	வானம்
freshtamil2_temp1_21	உள்ளே இருந்தால் ஓடித் திரிவான்; வெளியில் வந்தால் விரைவில் மடிவான் – அது என்ன?	மீன்
freshtamil2_temp1_22	எண்ணும் முள்ளும் இல்லாத கடிகாரம் எவராலும் பார்க்க இயலாத கடிகாரம் – அது என்ன?	இதயம்.
freshtamil2_temp1_23	ஏழை படுக்கும் பாய்; எடுத்துச் சுருட்ட ஆள் இல்லை – அது என்ன?	பூமி.
freshtamil2_temp1_24	ஒரு குருவிக்கு ஒரே கால்; நாலு இறக்கை – அது என்ன?	அரைக்கீரை.
freshtamil2_temp1_25	வாயைப் பிளந்து வீதியோரங்களில் நிற்பான் அவன் யார்?	தபாற் பெட்டி
freshtamil2_temp1_26	வீட்டுக்கு வந்த விருந்தாளியை வரவேற்க ஆளில்லை அது என்ன?	செருப்ப
freshtamil2_temp1_27	முக்கண்ணன் சந்தைக்குப் போகின்றான் அவன் யார்?	தேங்காய்
freshtamil2_temp1_28	ஒருவனுக்கு உணவளித்தால் ஊரையே கூட்டுவான். அவன் யார்?	காகம்
freshtamil2_temp1_29	அடிப்பக்கம் மத்தளம், இலை பர்வதம், குலை பெரிது, காய் துவர்ப்பு, பழம் தித்திப்பு. அது என்ன?	வாழைமரம்
freshtamil2_temp1_30	ஆயிரம் பேர் அணி வகுத்தாலும் ஆரவாரம் இராது” அவர்கள் யார்?	எறும்புக் கூட்டம்
pothunalam_1	பிடுங்கலாம் நட முடியாது அது என்ன..?	தலைமுடி
pothunalam_2	அடித்தாலும், உதைத்தாலும் அழ மாட்டான் அவன் யார்?	பந்து
pothunalam_3	யாரும் ஏறமுடியாத மரம், கிளைகள் இல்லாத மரம் அது என்ன?	வாழை
pothunalam_4	ஆயிரம் அறைகள் கொண்ட பிரம்மாண்டமான மிட்டாய் கடை அது என்ன?	தேன்கூடு
pothunalam_5	கசக்கிப் பிழிந்தாலும் கடைசிவரை இனிப்பான். அவன் யார்..?	கரும்பு
pothunalam_6	இடி இடிக்கும், மின்னல் மின்னும், மழை பெய்யாது- அது என்ன..?	பட்டாசு
pothunalam_7	உதை வாங்கி, உதை வாங்கி ஊருக்கு சேதி சொல்வான் அவன் யார்?	தண்டோரா
pothunalam_8	வாள் இல்லாமல் கேடயம் மட்டும் எப்போதும் வைத்திருக்கும், போருக்கு போகாத வீரன் அவன் யார்?	ஆமை
pothunalam_9	வயிற்றில் விரல் சுமப்பான், தலையில் கல் சுமப்பான் அவன் யார்?	மோதிரம்
pothunalam_10	உயிர் இல்லாத நீதிபதியிடம் ஒழுங்கான நியாயம் அது என்ன?	தராசு
pothunalam_11	அடி மலர்ந்து நுனி மலராத பூ எது?	வாழைப்பூ
pothunalam_12	ஐந்து அடுக்கு நான்கு இடுக்கு அது என்ன?	விரல்கள்
pothunalam_13	இரவல் கிடைக்காதது, இரவில் கிடைப்பது அது என்ன?	தூக்கம்
pothunalam_14	பூவுக்குள் பூ வைத்து போர்த்திய பூ அது என்ன?	வாழைப்பூ
pothunalam_15	இதயம் போல் துடித்திருக்கும் இரவு பகல் விழித்திருக்கும் அது என்ன?	கடிகாரம்
pothunalam_16	உருவம் இல்லாதவன் சொன்னதைத் திரும்பச் சொல்லுவான் அவன் யார்?	எதிரொலி
pothunalam_17	காலைக்கடிக்கும் செருப்பல்ல காவல் காக்கும் நாயல்ல அது என்ன?	முள்
pothunalam_18	அமைதியான பையன் ஆனால் அடிக்காமலேயே அழுவான் அவன் யார்?	ஐஸ் கட்டி
pothunalam_19	சின்னச் சின்ன அறைகள் உண்டு, இது வீடு அல்ல. சிறந்த அழகு கொண்டிருக்கும் சித்திரமும் அல்ல. காவலுக்கு ஆயிரம் வீரர்கள் உண்டு. கோட்டையும் அல்ல அது என்ன?	தேன் கூடு
pothunalam_20	ஒரே வயிற்றில் பிறந்தாலும் ஒருவன் ஓடுவான்.. ஒருவன் நடப்பான் அவன் யார்?	கடிகாரம்
pothunalam_21	உடல் சிவப்பு, வாய் அகலம், உணவு காகிதம் – நான் யார்?	அஞ்சல் பெட்டி
pothunalam_22	ஆடும் வரை ஆட்டம், ஆடிய பின் ஓட்டம் அது என்ன ?	இதயம்
pothunalam_23	உங்களுக்கு சொந்தமான ஒன்று ஆனால் உங்களை விட மற்றவர்களே அதிகம் உபயோகிப்பார்கள்?	பெயர்
pothunalam_24	இலையுண்டு கிளையில்லை, பூ உண்டு மணமில்லை,காய் உண்டு விதையில்லை, பட்டை உண்டு கட்டை இல்லை, கன்று உண்டு பசு இல்லை அது என்ன?	வாழை
pothunalam_25	இவனும் ஒரு பேப்பர் தான் ஆனால், மதிப்போடு இருப்பான். அது என்ன?	பணம்
pothunalam_26	டாக்டர் வந்தாரு, ஊசி போட்டாரு, காசு வாங்காமல் போனாரு.	கொசு
pothunalam_27	ஒன்று போனால் மற்றொன்றும் வாழாது?	செருப்பு
pothunalam_28	உணவு கொடுத்தால் வளரும் நீர் கொடுத்தால் அழியும். அது என்ன?	நெருப்பு
pothunalam_29	அள்ள முடியும், ஆனால் கிள்ள முடியாது அது என்ன?	நீர்
pothunalam_30	மூன்றெழுத்து பெயர், முற்றும் வெள்ளை நிறம் அது என்ன?	பஞ்சு
pothunalam_31	அந்தரத்தில் தொங்குது சொம்பும் தண்ணீரும். அது என்ன..?	இளநீர்
pothunalam_32	உருவத்தில் சிறியவன் உழைப்பில் பெரியவன் அவன் யார்..?	எறும்பு
pothunalam_33	காலால் தண்ணீர் குடித்து தலையால் முட்டை விடுவான் அவன் யார்..?	தென்னை மரம்
pothunalam_34	உடம்பு இல்லாத எனக்கு தலையுடன், பூ உண்டு நான் யார்..?	நாணயம்
pothunalam_35	ஏழை படுக்கும் பாய் எடுத்துச் சுருட்ட ஆள் இல்லை அது என்ன..?	பூமி
pothunalam_36	கண் இல்லாத நான் பார்வை இல்லாதவர்களுக்கு பாதை காட்டுவேன் நான் யார்..?	கைத்தடி
pothunalam_37	சின்னஞ் சிறு வீட்டில் சிப்பாய்கள் பல பேர் அது என்ன..?	தீக்குச்சி
pothunalam_38	உரசினால் போதும் உயிர் முடிந்து போகும் அது என்ன..?	தீக்குச்சி
pothunalam_39	கால் நான்கு நடக்காது கண் ஆயிரம் இமைக்காது அது என்ன..?	நாற்கட்டில்
pothunalam_40	உயிர் இல்லாப் பறவை ஊர் விட்டு ஊர் செல்லும் அது என்ன..?	கடிதம்
pothunalam_41	தாய் இனிப்பாள், மகள் புளிப்பாள், பேத்தி மணப்பாள் அது என்ன..?	பால், மோர், நெய்
pothunalam_42	பறிக்க பறிக்க பெரிதாகும் அது என்ன..?	குழி
pothunalam_43	கையும் இல்லை, காலும் இல்லை நான் ஓடிக்கொண்டே இருப்பேன் யார் தெரியுமா..?	நேரம்
