childhood-stories_1	చిన్న పాపకు చాలా చీరలు. ఏమిటది?	ఉల్లిపాయ
childhood-stories_2	జాన కాని జాన, ఏమి జాన?	ఖజాన
childhood-stories_3	తెలిసేలా పూస్తుంది, తెలియకుండా కాస్తుంది?	వేరుశెనగ కాయ
childhood-stories_4	లాగి విడిస్తేనే బ్రతుకు?	ఊపిరి
childhood-stories_5	పువ్వులో అందరికీ పనికి వొచ్చే పువ్వు?	పత్తి పువ్వు
childhood-stories_6	పెద్ద ఇంటిలో పొట్టివాన్ని నిలబెడితే నిండా నేనే?	దీపం
childhood-stories_7	పొద్దుటూరి చెట్లలో పొదిలింది చెళవాయి, చూసే వారే కాని పట్టే వారు లేరు?	సూర్యుడు
childhood-stories_8	మూత తెరిస్తే, ముత్యాల పేరు?	దంతాలు
childhood-stories_9	మేకల్ని తోలేసి తడకలకి పాలు పిండుతారు?	తేనె పట్టు
childhood-stories_10	మొగ్గ కాని మొగ్గ, ఏమి మొగ్గ?	లవంగ మొగ్గ
childhood-stories_11	ముళ్ల కంచెలో మిఠాయి పొట్లం?	తేనె పట్టు
childhood-stories_12	రసం కాని రసం, ఏమి రసం?	నీరసం
childhood-stories_13	మొదట చప్పన, నడుమ పుల్లన, కొస కమ్మన?	పాలు, పెరుగు, నెయ్యి
childhood-stories_14	మోదం కాని మోదం?	ఆమోదం
childhood-stories_15	రెక్కలు లేని పిట్ట గూటికి సరిగా చేరింది?	ఉత్తరం
childhood-stories_16	కొక లేదు, సీత కాదు! రామ చిలుక కానేకాదు!! అదేమిటి?	సీతాకోక చిలుక
childhood-stories_17	రాజాధి రాజులు కూడా ఒకరిముందు తల వంచుకుంటారు?	మంగలి
childhood-stories_18	రాజు నల్లన ప్రధాన పచ్చన, పాలు పుల్లన?	తాటి చెట్టు
childhood-stories_19	రెండు కొడతాయి, ఒకటి పెడుతుంది?	ఎండ, వాన, చలి
childhood-stories_20	రాళ్ల అడుగున విల్లు, విల్లు కోనలో ముళ్లు?	తేలు
childhood-stories_21	అందమైన గిన్నెలో ఎర్రని పిట్ట తోకతో నీళ్లు త్రాగుతుంది	దీపం వత్తి
childhood-stories_22	కడుపు నిండా రాగాలు, వంటి నిండా గాయాలు?	మురళి
childhood-stories_23	ఇష్టంగా తెచ్చుకుంటారు, చంపి ఏడుస్తారు?	ఉల్లి
childhood-stories_24	సముద్రంలో పుట్టిపెరిగి ఊరిలో అరుస్తుంది, ఏమిటది?	శంఖం
childhood-stories_25	నీళ్లు నుంచి వ‌స్తుంది. నీకు నాకూ రుచిస్తుంది? ఇంత‌కీ ఏమిట‌ది?	పొట్ల‌కాయ‌లు
childhood-stories_26	ఆకులు లేని అడ‌విలో జీవం లేని జంతువు జీవాల‌ను వేటాడుతుంది ఏంట‌ది?	దువ్వెన‌
childhood-stories_27	వీధిరాజుకు కొప్పుది కానీ జుట్టు లేదు, క‌ళ్ళున్నాయి కానీ చూపులేదు ఏంట‌ది?	కొబ్బ‌రికాయ‌
childhood-stories_28	ఆరు ఆమ‌డ‌ల నుండి అల్లుడు వ‌స్తే అత్త‌గారు వ‌డ్డించింది విత్తులేని కూర ఏంట‌ది?	పుట్ట‌గొడుగుల కూర‌
childhood-stories_29	తెల్ల‌టి పొలంలో న‌ల్ల‌టి విత్త‌నాలు, చేతితో చ‌ల్లుతాం, నోటితో ఏరుతాం ఏమిట‌వి?	పుస్త‌కంలో అక్ష‌రాలు
childhood-stories_30	ముక్కు మీద‌కెక్కు, ముదుర చెక్కుల నొక్కు, ట‌క్కు నిక్కుల సొక్కు జారిందో పుటుక్కు ఏమిట‌ది?	క‌ళ్ల‌జోడు
childhood-stories_31	తోలు న‌లుపు, తింటే పులుపు, ఏంటో అది?	చింత‌పండు
childhood-stories_32	కుడితి తాగ‌దు, మేత మెయ్య‌దు, కానీ క‌డివెడు పాలు ఇస్తుంది. ఏంట‌ది?	తాటిచెట్టు
childhood-stories_33	స‌న్న‌టి స్థంభం, ఎవ్వ‌రూ ఎక్క‌లేరు, దిగ‌లేరు ఏంట‌ది?	సూది
childhood-stories_34	అగ్గిపెట్టెలో ఇద్ద‌రు పోలీసులు ఏంట‌ది?	వేరుశ‌న‌గ కాయ‌
childhood-stories_35	ఇంట్లో మొగ్గ బ‌య‌ట‌కొస్తే పువ్వు?	గొడుగు
childhood-stories_36	కాళ్ళున్నా పాదాలే లేనిది ఏంట‌ది?	కుర్చీ
childhood-stories_37	చ‌క్క‌న‌మ్మ చిక్కినా అందంగా ఉంటుంది? ఏంట‌ది?	స‌బ్బు
childhood-stories_38	ప‌చ్చ‌ని పాముకు తెల్ల‌ని చార‌లు? ఏంట‌ది?	పొట్ల‌కాయ‌
childhood-stories_39	నాలుగు క‌ర్ర‌ల మ‌ద్య న‌ల్ల‌రాయి? ఏంట‌ది?	ప‌ల‌క‌
childhood-stories_40	చెట్టుకు కాయ‌ని కాయ కర‌క‌ర‌లాడే కాయ‌? ఏంట‌ది?	క‌జ్జికాయ‌
childhood-stories_41	అడ‌విలో పుట్టాను అడ‌విలో పెరిగాను వంటినిండా గాయాలు క‌డుపునిండా రాగాలు	ముర‌ళి – ఫ్లూట్‌
childhood-stories_42	ఈ ప్ర‌పంచ‌లోని వారంద‌రూ నా బిడ్డ‌లే కాని అమ్మా! అని న‌న్నెవ‌రు పిల‌వ‌రు ఏం చేయాల‌న్నా ఏమి పొందాల‌న్నా నాలోనే ఎటూ పోవాల‌న్నా ఎక్క‌డికి వెళ్లాల‌న్నా నా మీదే..నేనెవ‌ర్ని?	భూమి
childhood-stories_43	తెల్ల‌టి శ‌న‌గ‌ల‌లో ఒక‌టేరాయి, చేతితో చ‌ల్ల‌డం నోటితో ఏరుకోవ‌డం ఏంట‌ది?	పుస్త‌కం
childhood-stories_44	రాజుగారి తోట‌లో రోజాపూలు చూచేవారేగాని లెక్క‌వేసేవారు కాదు ఏమిట‌వి?	చుక్క‌లు
childhood-stories_45	జీడివారి కోడ‌లు సిరిగ‌ల వారికి ఆడ‌ప‌డుచు వ‌య‌సులో కులికే వ‌య్యారి వైశాఖ‌మాసంలో వ‌స్తుంది.	మామిడి పండు
childhood-stories_46	కిరు కిరు త‌లుపులు కిటారు త‌లుపులు వెయ్యంగ వెయ్య‌స్త‌వి గాని తియ్యంగా తియ్య‌రావు ఏంట‌వి?	ముగ్గు
childhood-stories_47	అడ‌విలో పుట్టింది అడ‌విలో పెరిగింది మా ఇంటికొచ్చింది తైత‌క్క లాడింది.	చిల్ల క‌వ్వ‌
childhood-stories_48	పొంగ బోడ‌ది రాంగ జుట్టుది ఏంట‌ది?	పేలాలు
childhood-stories_49	చీక‌టింట్లో జ‌డ‌ల ద‌య్యం ఏమిట‌ది?	ఉట్టి
childhood-stories_50	గారు కాని గారు, ఏమిగారు?	కంగారు
childhood-stories_51	అది లేకపోతే ఎవ్వరూ ఏమీ తినరు?	ఆకలి
childhood-stories_52	అందరూ నన్ను పట్టుకుంటారు కాని నేనే ఎవరిని పట్టుకొను, అందరూ నాతో మాట్లాడతారు కాని నేనే ఎవరితో మాట్లాడను?	టెలిఫోన్
childhood-stories_53	గీత కాని గీత, ఏమి గీత?	భగవద్గీత
childhood-stories_54	గోళము కాని గోళము, ఏమి గోళము?	గందర గోళము
childhood-stories_55	అన్నం పెడితే ఎగురదు, పెట్టకపోతే ఎగురుతుంది?	విస్తరాకు
childhood-stories_56	అడవిలో చిన్న గని, గనికి చాలా గదులు, గదికొక్క సిపాయి, సిపాయికొక్క తుపాకి?	తేనే పట్టు
childhood-stories_57	అన్నదమ్ములు ముగ్గురు, తిరిగితే ముగ్గురూ తిరుగుతారు, మానితే ముగ్గురూ మానుతారు?	ఫ్యాన్
childhood-stories_58	అబ్బాయి గారి దొడ్లో పెద్ద పండు పడితే, పరుగెత్తలేక పది మంది చచ్చారు.	పిడుగు
childhood-stories_59	ఆడవారికి ఉండనిది, మగవారికి ఉండేది?	మీసము
childhood-stories_60	ఆడదానికి పుట్టినింట ఒకటి, మెట్టినింట ఒకటి?	ఇంటి పేరు
childhood-stories_61	ఆడవారు తక్కువగా మాట్లాడే నెల?	ఫిబ్రవరి
childhood-stories_62	ఇల్లంతా తిరిగి మూలకు కూర్చుంటుంది?	చీపురు
childhood-stories_63	ఇళ్ళు లేని పట్నాలు, నీళ్లు లేని సముద్రాలు ఎక్కడ ఉంటాయి?	మ్యాపులో
childhood-stories_64	ఇంటిలో ఉంటే ప్రమోదము, ఒంటిలో ఉంటే ప్రమాదము?	పంచదార
childhood-stories_65	ఇక్కడ వత్తు! అక్కడ వెలుగు!!?	స్విచ్, బల్బ్
childhood-stories_66	అన్నదమ్ములు ఇద్దరు, ఒకరంటే మరొకరికి పడదు, ఎప్పుడూ కొట్టుకుంటూనే ఉంటారు. వారి మధ్యకు ఎవరైనా వొస్తే పచ్చడి పచ్చడే?	ఇసుర్రాయి
childhood-stories_67	ఇద్దరు అక్క చెల్లెల్లు, ప్రపంచం మొత్తం తిరిగి చూసినా, ఒకరినొకరు చూసుకోరు?	కళ్ళు
childhood-stories_68	ఇల్లు మొత్తం వెలుగు, బల్ల కింద చీకటి?	దీపం
childhood-stories_69	ఇవ్వకుండా తీసుకో లేనిది! తీసుకోకుండా ఇవ్వ లేనిది!!?	ముద్దు
childhood-stories_70	అన్నదమ్ములు ఇద్దరు, ఒకరు ఎంత దూరం పోతే రెండవ వారు అంతే దూరం పోతారు?	కాళ్ళు
childhood-stories_71	ఈగ ముసరని పండు! ఇంటిలో నుండు!!?	నిప్పు
childhood-stories_72	ఈత చెట్టుకు ఇద్దరు బిడ్డలు?	కల్లు కుండలు
childhood-stories_73	ఊరంతా కదిలిన, ఊరగాయ కుండ కదలదు?	బావి
childhood-stories_74	ఉరికంత ఒక్కటే దుప్పటి?	ఆకాశము
childhood-stories_75	ఎర్రనిచెట్టు! నీళ్లు పోస్తే చస్తుంది!!?	అగ్ని
childhood-stories_76	మాములు వేళలో మర్యాదగా ఉంటుంది, ఎండకు వానకు నెత్తినెక్కుతుంది?	గొడుగు
childhood-stories_77	ఎర్రగా ఉంటాను కాని నేనెవరితో సరసాలాడను, నన్ను ముట్టుకుంటే ఊరుకోను.	నిప్పు
childhood-stories_78	ఎగిరే పిట్ట, రెక్కలు లేని పిట్ట! ఆటలాడుకునే పిట్ట, పిల్లల పిట్ట!!?	గాలి పటము
childhood-stories_79	ఎనమిది ఎముకలు! తట్టెడు ప్రేగులు!!?	మంచము
childhood-stories_80	ఎముకలు లేని జీవము, ఏటికి పోయింది?	జలగ
childhood-stories_81	ఏది పెడితే అరిగి పోతుంది?, ఏది పెడితే కలకాలం ఉంటుంది?	అన్నము, వాత
childhood-stories_82	అమ్మంటే దగ్గరకొచ్చి నాన్నంటే దూరంగా పోతాయి?	పెదవులు
childhood-stories_83	ఒకటి పట్టుకుంటే రెండు ఊగుతాయి?	తక్కెడ
childhood-stories_84	అడుగులున్నా, కాళ్ళులేనిది?	గజము బద్ద, మీటర్ స్కేలు
childhood-stories_85	ఒకరు పొడుస్తారు, ఒకరు విడుస్తారు?	పొడుపు కథ
childhood-stories_86	నల్ల స్తంభం పైన నలుగురు దొంగలు?	లవంగం మొగ్గ
childhood-stories_87	అందని వస్త్రం పై అన్నీ వడియాలే?	నక్షత్రాలు
childhood-stories_88	కాయలు కాని కాయలు, ఏమి కాయలు?	మొట్టి కాయలు
childhood-stories_89	అందరికి చెప్పి వొచ్చేది, చెప్పకుండా వెళ్ళేది?	ప్రాణం
childhood-stories_90	అందమైన చిన్నది, అందాల చిన్నది, నువ్వు చుస్తే నిన్ను చూస్తుంది, నేను చుస్తే నన్ను చూస్తుంది?	అద్దము
childhood-stories_91	కీచు కీచు పిట్ట! నేలకేసి కొట్ట!!	చీమిడి
childhood-stories_92	కిట కిట తలుపులు! కిటారు తలుపులు!! ఎప్పుడు తీసినా చప్పుడు కాదు?	కను రెప్పలు
childhood-stories_93	కిరీటము ఉంటుంది కాని రాజును కాదు, నాట్యము చేస్తాను కాని మయూరిని కాదు?	నాగుపాము
childhood-stories_94	కాటుక రంగు, కమలము హంగు! విప్పిన పొంగు, ముడిచిన క్రుంగు!!?	గొడుగు
childhood-stories_95	తల లేదు కాని గొడుగు ఉంది, పాము లేదు కాని పుట్ట ఉంది?	పుట్ట గొడుగు
childhood-stories_96	కడుపు లోన పిల్లలు, కంఠము లోన నిప్పులు! అరుపేమో ఉరుము, ఎరుపంటే భయము!!?	రైలు
childhood-stories_97	కార్డు కాని కార్డు, ఏమి కార్డు?	రికార్డు
childhood-stories_98	కాయ, పువ్వు లేని పంట?	ఉప్పు పంట
childhood-stories_99	కలి కాని కలి, ఏమి కలి?	చాకలి
childhood-stories_100	కోడి కాని కోడి, ఏమి కోడి?	చకోడి
childhood-stories_101	కొనే టప్పుడు నలుపు, తినేటప్పుడు ఎరుపు, పారేసేటప్పుడు తెలుపు ఏమిటది?	పుచ్చకాయ
childhood-stories_102	అన్నింటికన్నా విలువైనది, అందరికి అవసరమైనది?	ప్రాణము
childhood-stories_103	గింజ మునుగుతుంది, కాయ తేలుతుంది?	వేరుశెనగ కాయ
childhood-stories_104	కర్రలతో అతి చిన్న కర్ర?	జీలకర్ర
childhood-stories_105	గట్టుమీద రాయి! మినుకు మినుకు రాయి!!	ముక్కు పుడక
childhood-stories_106	గాలిలో ఎగిరే అద్దము పట్టుకుంటే పలిగి పోవు?	సబ్బు బుడగ
childhood-stories_107	కాయ కాని కాయ, అతి చిన్న కాయ?	చెమటకాయ
childhood-stories_108	గోడకు గొలుసు పండు!?	లాంతరు
childhood-stories_109	చీకటి ఇంటిలో జడల దయ్యము?	ఉట్టి
childhood-stories_110	చింపిరి గుడ్డలు! బంగారం లాంటి బిడ్డలు!!	మొక్క జొన్న
childhood-stories_111	చిన్న చిట్టిలో కమ్మని కూర?	కిల్లీ
childhood-stories_112	చిక్కటి కారడవిలో చక్కటి దారి?	పాపిట
childhood-stories_113	చారల పాపకి దూది కుచ్చు!	ఉడుత
childhood-stories_114	నూరు పళ్ళు ఒకటే నోరు?	దానిమ్మ
childhood-stories_115	సన్నని స్తంభం, ఎక్కలేరు, దిగలేరు?	సూది
childhood-stories_116	ఎర్రవాడొస్తే తెల్లవాడు, పారిపోయి దాక్కుంటాడు?	సూర్యుడు, చంద్రుడు
childhood-stories_117	పొంచిన దయ్యం! ఉన్న చోట ప్రత్యక్షం!!	నీడ
childhood-stories_118	అంగట్లో ఉంటాను, ఇంట్లో అంగి విప్పుతాను! నన్ను గాని ముట్టుకుంటే నూతిలో దూకుతాను!!	అరటి పండు
childhood-stories_119	ఇంట్లో మొగ్గ, వీధిలో పువ్వు?	గొడుగు
childhood-stories_120	అడవిలో పుట్టాను, నల్లగా అయ్యాను, ఇంటికి వచ్చాను, ఎర్రగా మారాను, తొట్టిలో పడ్డాను తెల్లగా మారాను?	బొగ్గు
childhood-stories_121	పైన పచ్చ ఏనుగు, లోన తెల్ల పీనుగు?	అరటి కాయ
childhood-stories_122	బారు కాని బారు, ఏమి బారు?	సాంబారు
childhood-stories_123	పిల్లలకు ఉచితము! పెద్దలకు బహుమానము!! యూవతీ యువకులకు అపురూపము, అందరికీ ఇష్టము?	ముద్దు
childhood-stories_124	హారము కాని హారము, ఏమి హారము?	ఆహారము
childhood-stories_125	పుట్టినపుడు పురుగు! పెరిగితే పువ్వుల రాజు?	భ్రమరము
childhood-stories_126	బడి కాని బడి, ఏమి బడి?	రాబడి
childhood-stories_127	పగలు తపస్వి, రాత్రి పండ్ల తోటలో రాక్షసి!?	గబ్బిలం
childhood-stories_128	బొట్టు కాని బొట్టు, ఏమి బొట్టు?	తాళిబొట్టు
childhood-stories_129	పచ్చని గుడిలో ఎరుపు రత్నాలు?	దానిమ్మ గింజలు
childhood-stories_130	బాడీ కాని బాడీ, ఏమి బాడీ?	లంబాడి
childhood-stories_131	పలుకు కాని పలుకు, ఏమి పలుకు?	వక్క పలుకు
childhood-stories_132	పైన పటారాము! లోన లొటారాము!!?	మేడి పండు
childhood-stories_133	మతి కాని మతి, ఏమి మతి?	శ్రీమతి
childhood-stories_134	మంచము కింద మామ! ఉరికి పోదాం రావా!!?	చెప్పులు
childhood-stories_135	మర కాని మర, ఏమి మర?	పడమర, అలమర
childhood-stories_136	మూడు కన్నులుండు, ముక్కంటిని కాను! నిండా నీరు ఉండు, కుండను కాను!!	కొబ్బరి కాయ
childhood-stories_137	మామ కాని మామ, ఏమి మామ?	చందమామ
childhood-stories_138	మీకు సొంతమైనది కాని, మీకన్నా మీ తోటి వారు ఎక్కువగా వాడతారు?	మీ పేరు
childhood-stories_139	మని కాని మని, ఏమి మని?	ఆమని
childhood-stories_140	మానము కాని మానము, ఏమి మానము?	విమానము
childhood-stories_141	మేమిద్దరం మిమ్మల్ని మోస్తాము, మీ అవసరము తీరాక మూలన పడుకుంటాము?	చెప్పులు
childhood-stories_142	పచ్చని పొదలో పిచ్చుక విచ్చుకుంది! తెచ్చుకోబోతే గుచ్చుకుంది?	మొగిలి పువ్వు
childhood-stories_143	చెవుల పక్క నక్కి ముక్కు మీదకెక్కుతుంది?	కళ్ళ జోడు
childhood-stories_144	మేక తిన్నాను, తోక పారేశాను?	వంకాయ
childhood-stories_145	మూసింది తెరువ! తెరువంగ అరువ!!?	ఆవులింత
childhood-stories_146	రాజు వారి తోటలో రోజూ కాసే పూలు! చూసే వారే కాని కోసే వారు లేరు!!?	నక్షత్రాలు
childhood-stories_147	వరి కాని వరి, ఏమి వరి?	జనవరి
childhood-stories_148	ప్రపంచం మొత్తం తిరిగేది, అన్నింటికన్నా వేగమైనది?	మనసు
childhood-stories_149	శాఖలున్నా ఆకులు లేనిది?	సంస్థ
childhood-stories_150	చాచుకొని, సావిట్లో పడుకునే ముసలమ్మ, ముడుచుకొని మూల నిలబడింది?	చాప
childhood-stories_151	చెయ్యని కుండ! పోయని నీరు!!?	కొబ్బరి కాయ
childhood-stories_152	నరుడు కాని నరుడు, ఏమి నరుడు?	వానరుడు
childhood-stories_153	నగలు కాని నగలు, ఏమి నగలు?	శెనగలు
childhood-stories_154	నూరుగురు అన్నా తమ్ముళ్లకు ఒకటే మొలతాడు?	చీపురు
childhood-stories_155	పట్టుకుంటే పిడికెడు, విడిస్తే ఇల్లంతా?	దీపం
childhood-stories_156	పట్టు సంచిలో బంగారు గుడ్లు?	ఎండు మిరపకాయలు
childhood-stories_157	మనదొకటి తడవదు, ఎండదు, ఆరదు?	నీడ
childhood-stories_158	వెండి గిన్నెలో దాగిన బంగారం?	కోడి గుడ్డు
childhood-stories_159	మనిషి మనిషి మధ్య రథ సారథి నేను, నేను లేకుంటే ప్రపంచమే లేదు?	ప్రేమ
childhood-stories_160	రెక్కలుంటాయి, రయ్ రయ్ మంటుంది, ఎగురలేదు కాని ఎగురవేస్తుంది?	ఫ్యాన్
childhood-stories_161	రణము కాని రణము, ఏమి రణము?	చరణము
childhood-stories_162	బంగారు బిడ్డలు, వెచ్చని దుస్తులు, గుర్రపు వెంట్రుకలు?	మొక్కజొన్న
childhood-stories_163	రాయి కాని రాయి, ఏమి రాయి?	కిరాయి
childhood-stories_164	ఉన్న చోటే ఉంటుంది, వేళా పాలా చెపుతుంది?	గోడ గడియారం
childhood-stories_165	రంగము కాని రంగము, ఏమి రంగము?	చదరంగము
childhood-stories_166	మతము కాని మతము, ఏమి మతము?	కమతము
childhood-stories_167	అన్నకు అందవు కాని తమ్ముడికి అందుతాయి?	పెదవులు
childhood-stories_168	వాలు కాని వాలు, ఏమి వాలు?	ఆనవాలు
childhood-stories_169	రేట్లెంత పెరిగినా ఎప్పుడూ పది పైసలకు రెండు వొచ్చేవి?	రెండు ఐదు పైసల బిళ్ళలు
childhood-stories_170	వల కాని వల, ఏమి వల?	నవల
childhood-stories_171	రోజుకో ఆకారం మారుస్తాడు, చివరకు నిండు సున్నా అవుతాడు?	చంద్రుడు
childhood-stories_172	గుప్పెడంత లోగిలిలో యాభై మంది నివాసం?	అగ్గి పెట్టె
childhood-stories_173	వారు కాని వారు, ఏమి వారు?	నవారు
childhood-stories_174	విత్తనం లేకుండా మొలిచేది?	గడ్డము
childhood-stories_175	కాళ్ళు లేవు కానీ నడుస్తుంది ? కళ్ళు లేవు కానీ ఏడుస్తుంది ?	మేఘం
telugu_huggingface_processed_review_1	అందమైన సరస్సులో ఎర్రపిట్ట తోకతో నీళ్ళు తాగుతోంది	దీపపు వత్తి
telugu_huggingface_processed_review_2	దండ కాని దండ?	అండదండ, కైదండ
telugu_huggingface_processed_review_3	తెల్లని విస్తరిలో నల్లని మెతుకులు	అక్షరాలు
telugu_huggingface_processed_review_4	నువ్వు ఒక గది లోనికి వెళ్ళినప్పుడు అక్కడ ఒక అగ్గి పెట్టి, ఒక కిరోసిన్ ల్యాంప్, ఒక క్యాండిల్ ఉంటాయి. నువ్వు మొదటిగా దేనిని వెలిగిస్తావు?	అగ్గి పెట్టె
telugu_huggingface_processed_review_5	వేలెడంత లోగిలిలో, ఏభైమంది నివాసము!	అగ్గి పెట్టెలోని పుల్లలు
telugu_huggingface_processed_review_6	తెల్లటోడు నల్లటోడిని తన్ను!	అగ్గిపెట్టె
telugu_huggingface_processed_review_7	అంగుళం గదిలో అరవైమంది	అగ్గిపెట్టె
telugu_huggingface_processed_review_8	అర కణం గదిలో 60 మంది నివాసం?	అగ్గిపెట్టె, అగ్గి పుల్లలు
telugu_huggingface_processed_review_9	నీవు ఎన్ని తీసుకుంటే నీ వెనకాల అన్ని మిగిలిపోతాయి ఎవరి నేను?	అడుగులు
telugu_huggingface_processed_review_10	‘డ్రస్’ గాని డ్రస్! ఏమి డ్రస్?	అడ్రస్
telugu_huggingface_processed_review_11	తెలిసి కాయ కాస్తుంది. తెలీకుండా పువ్వు పూస్తుంది.	అత్తి చెట్టు
telugu_huggingface_processed_review_12	ముట్టుకుంటే ముడుచుకుంటుంది. పట్టుకుంటే గుచ్చుకుంటుంది.	అత్తిపత్తి
telugu_huggingface_processed_review_13	ఒక ట్రైన్ పడమర వైపు వెళుతూ ఉంది దాని పొగ ఎటువైపు వెళుతుంది?	అది ఎలక్ట్రిక్ ట్రైన్ కనుక దానికి పొగ అనేదే ఉండదు
telugu_huggingface_processed_review_14	ఒక వ్యక్తి తన కుక్కను ఒక నదికి ఇవతల నుంచి అవతలకు దాటి రమ్మన్నాడు అది దాటి వచ్చింది కానీ దాని శరీరానికి ఏమాత్రం తడి అంటలేదు, ఎందుకు?	అది మంచుతో కప్పబడి వుంది.
telugu_huggingface_processed_review_15	చూస్తే చూసింది గానీ కళ్లు లేవు. నవ్వితే నవ్వింది గాని పళ్లు నోరు లేదు, తంతే తన్నింది గాని కాలు లేదు.	అద్దం
telugu_huggingface_processed_review_16	అరచేతి పట్నాన 60 వాకిళ్ళు?	అద్దం
telugu_huggingface_processed_review_17	అబద్ధం అంటే తెలియని అమాయకురాలు,	అద్దం
telugu_huggingface_processed_review_18	అరచేతి పట్నాన అరవై వాకిళ్ళు.	అద్దం
telugu_huggingface_processed_review_19	నన్ను చూస్తే నిన్ను పట్టిస్తా?	అద్దం
telugu_huggingface_processed_review_20	చూస్తే చూపులు - నవ్వితే నవ్వులు,	అద్దం
telugu_huggingface_processed_review_21	భగవంతుని ప్రతిరూపమును నేను! నన్ను మంగళకరముగా భావిస్తారు. మనిషి మనిషికీ ప్రతిరోజూ ప్రతిపూటా ఉపయోగపడతాను.	అద్దము
telugu_huggingface_processed_review_22	ఈకలు లేని కోడి ఇల్లెక్కింది?	అనపకాయ, సొరకాయ
telugu_huggingface_processed_review_23	అర్ధరూపాయి మేక, దాని సంక నువ్వు నాక	అన్నం తినే పళ్ళెం
telugu_huggingface_processed_review_24	లంక తగుల బెడితే, లచ్చి మొత్తుకునే!	అన్నము ఉడుకుట
telugu_huggingface_processed_review_25	ఏ నెలలో 28 రోజులు ఉంటాయి?	అన్ని నెలలలో
telugu_huggingface_processed_review_26	ఇంతింతాకు, బ్రహ్మంతాకు, విరిస్తే ఫెళఫెళ?	అప్పడం
telugu_huggingface_processed_review_27	నాకు (మగ వారికి) ఉండేది! నీకు (ఆడవారికి) ఉండేది! అవేమిటో చెప్పు?	అప్పు, కొప్పు
telugu_huggingface_processed_review_28	‘మొగుడు గాని మొగుడు’ ఏ మొగుడు?	అప్పుల మొగుడు
telugu_huggingface_processed_review_29	హద్దు లేని పద్దు?	అబద్దం
telugu_huggingface_processed_review_30	హద్దు లేని పద్దు ఎన్నడూ ఆడొద్దు	అబద్దం
telugu_huggingface_processed_review_31	భయం కాని భయం?	అభయం
telugu_huggingface_processed_review_32	మీ మావయ్య గారి చెల్లి నీకు పెద్దమ్మ, పిన్ని కాక పోతే ఏమవుతుంది?	అమ్మ
telugu_huggingface_processed_review_33	బిందె మీద బిందె అల్లాడే పది పందిళ్ళు?	అరటి గెల
telugu_huggingface_processed_review_34	"జిలుగు జిలుగు నీటిలో జీలుగు పుట్టె! ఆకు పుట్టె! అంతరాల కొడుకు పుట్టె! కొడుకును కొట్టి, కోడలు ముండ మోసె!	అరటి చెట్టు
telugu_huggingface_processed_review_35	"తొలు తియ్యన, గుండు మింగన్నా?	అరటి పండు
telugu_huggingface_processed_review_36	అంగట్లొ ఉంటాను, అంగీ ఇంట్లొ విప్పుతాను, ఎవరన్నా పట్టుకుంటే, నూతిలో దూకుతాను	అరటి పండు
telugu_huggingface_processed_review_37	కతకత కంగు, కామరాజు పింగు, తోలుతీసి మింగు	అరటి పండు
telugu_huggingface_processed_review_38	చిటపట వానలు కురవంగా! సీతాదేవి పుట్టంగా! లంకా దీపము పెట్టంగా! రాముడు విల్లును విఱువంగా!	అరటి పువ్వు
telugu_huggingface_processed_review_39	కొత్త పెళ్లి కొడుకు బట్టలన్నీ విప్పేసి బావిలో దూకాడు కానీ మళ్లీ తిరిగి రాలేదు?	అరటిపండు
telugu_huggingface_processed_review_40	భోగపుదాన బొచ్చులదాన, కొనవిచ్చని పువ్వేది	అరటిపువ్వు
telugu_huggingface_processed_review_41	ఆకాశాన అంగవస్త్రాలు ఆరవేశారు?	అరిటాకు
telugu_huggingface_processed_review_42	సల సలా కాగే నీళ్ళలో సీతమ్మ స్నానమాడు.,	అరిసెలు
telugu_huggingface_processed_review_43	ఎందరు ఎక్కిన విరగని మంచం కదలదు జోగదు బెదరదు కూడ.,	అరుగు
telugu_huggingface_processed_review_44	ఎందరు ఎక్కిన విరగని మంచం.,	అరుగు.
telugu_huggingface_processed_review_45	భార్య లేని పతి ఎవరు?	అల్లోపతి
telugu_huggingface_processed_review_46	మానం కాని మానం?	అవమానం, బహుమానం, కొలమానం
telugu_huggingface_processed_review_47	ఒక పాప ఒక బంతిని విసిరినప్పుడు అది మరలా తన చేతిలోకి వెనుకకు వచ్చి చేరుతుంది, ఎలా(ఎవరు విసర కుండా)?	ఆ పాప ఆ బంతిని గాలిలోకి పైకి విసురుతుంది
telugu_huggingface_processed_review_48	అదిలేకపోతే ఎవ్వరూ ఏమీ తినరు. ఏమిటి?	ఆకలి
telugu_huggingface_processed_review_49	చిన్నా, పెద్ద భేదము లేదు. “వారు వీరు” అని అసలే లేదు. ప్రతిరోజూ మూడు పూటలా సర్వ ప్రాణులకు వేసేది ఏది?	ఆకలి
telugu_huggingface_processed_review_50	కానరాని అడవిలో నీళ్ళు లేని మడుగు, నీళ్ళు లేని మడుగులో కానరాని నిప్పు	ఆకలి
telugu_huggingface_processed_review_51	కలి గాని కలి! ఏమి కలి?	ఆకలి, చాకలి
telugu_huggingface_processed_review_52	రుచి లేని కారం ఏమిటి?	ఆకారం
telugu_huggingface_processed_review_53	“టిక్కు” మనగానే మాట్లాడతాను. “టక్కు” మనగానే ఆగిపోతాను.	ఆకాశ వాణి
telugu_huggingface_processed_review_54	ఊరంతకీ ఒక్కటే దుప్పటి,	ఆకాశం
telugu_huggingface_processed_review_55	చాప చుట్టనూ లేము, చంక బెట్టనూ లేము	ఆకాశం
telugu_huggingface_processed_review_56	పెద్దన్న ఇచ్చెనూ పచ్చల్ల గొడుగు, పచ్చల్ల గొడుగుకూ పగడాల పూలు	ఆకాశం, నక్షత్రాలు
telugu_huggingface_processed_review_57	చెట్టు చూడు. చెట్టందం చూడు. చిత్రమైన చిగురాకును చూడు. పూసిందంటే ఒకటే పూవు చూడు. కాసిందంటే గంపెడు కాయలు చూడు.,	ఆకాశం, చంద్రుడు, చుక్కలు, వెన్నెల
telugu_huggingface_processed_review_58	అంతులేని చెట్టుకు అరవై కొమ్మలు, కొమ్మ కొమ్మకు కోటిపువ్వులు, అన్ని పువ్వుల్లో రెండేకాయలు?	ఆకాశం, చుక్కలు, సూర్యుడు
telugu_huggingface_processed_review_59	అందమైన వస్త్రంపై అన్నీ వడియాలే,	ఆకాశంలో నక్షత్రాలు
telugu_huggingface_processed_review_60	గోరు వంకకు గొడుగును పట్టేదెవరు?	ఆకాశము
telugu_huggingface_processed_review_61	చక్కని పాపకు చుక్కల చీర!	ఆకాశము
telugu_huggingface_processed_review_62	లోకమంతటికి ఒకటే పందిరి-ఒకటే అరుగు	ఆకాశము-భూమి
telugu_huggingface_processed_review_63	నీలము చీర, మధ్యలో వెన్న ముద్ద, అక్కడక్కడ అన్నపు మెతుకులు	ఆకాశములో చంద్రుడు, చుట్టూ నక్షత్రాలు
telugu_huggingface_processed_review_64	అన్నదమ్ములం ముగ్గురం మేము, శుభవేళల్లో కనిపిస్తూ వుంటాము;	అయితే బుద్ధులు వేరు
telugu_huggingface_processed_review_65	నీళ్ళలో మునిగే వాడొకడు: తేలే వాడొకడు;	కరిగే వాడొకడు:
telugu_huggingface_processed_review_66	అయితే మే మెవరం?	ఆకు, వక్క, సున్నం.
telugu_huggingface_processed_review_67	తరచి తరచి చూసినా లోతు తెలియనిది?	ఆడదాని మనసు
telugu_huggingface_processed_review_68	తాళము గాని తాళము! ఏమి తాళము?	ఆది తాళము
telugu_huggingface_processed_review_69	‘వాలు’ గాని వాలు! ఏమి వాలు?	ఆనవాలు, ఆవాలు
telugu_huggingface_processed_review_70	అడ్డగోడమీద బుడ్డ చెంబు, తోసినా ఇటుపక్క పడదు. అటు పక్క పడదు.	ఆబోతు మూపురం.
telugu_huggingface_processed_review_71	దాని మొదలు చెరకు మొదలు. దాని ఆకు తామరాకు దాని పూత మేడి పూత దాని కాత గజ్జి కాత,	ఆముదపు చెట్టు
telugu_huggingface_processed_review_72	సమంత డిసెంబర్ 26 న పుట్టింది కానీ ఆమె పుట్టిన రోజు మాత్రం ఎండాకాలం వస్తుంది ఎలా?	ఆమె దక్షిణ అర్థగోళం లో వుంది కనుక
telugu_huggingface_processed_review_73	షాప్ వాడు ఫ్రీ అన్నకూడా,మనం అడగలేనిది?	ఆల్కహాల్ ఫ్రీ గ్రైప్ వాటర్
telugu_huggingface_processed_review_74	చారలు లేని జీబ్రా ఏమిటి?	ఆల్జీబ్రా
telugu_huggingface_processed_review_75	వడకాని వడ	ఆవడ, పావడ, దవడ
telugu_huggingface_processed_review_76	వాలు కాని వాలు	ఆవాలు, కోవాలు, ఆనవాలు, ఏటవాలు
telugu_huggingface_processed_review_77	నడిచిపోయే తెల్లరాతికి నాలుగు కాళ్ళు?	ఆవు
telugu_huggingface_processed_review_78	అంగట్లో పెట్టి అమ్మేది కాదు, తక్కెట్లో పెట్టి తూచేది కాదు, అది లేకుంటే పండగే జరుగదు	ఆవు పేడ
telugu_huggingface_processed_review_79	రేపటి పై నమ్మకం పెంచేది?	ఆశ
telugu_huggingface_processed_review_80	పూజకు పనికిరాని పత్రి ఏమిటి?	ఆసుపత్రి
telugu_huggingface_processed_review_81	హారము గాని హారము! ఏమి హారము?	ఆహారము
telugu_huggingface_processed_review_82	ఇంటికి పెట్టలేని గేట్ ఏమిటి?	ఇంటరాగేట్
telugu_huggingface_processed_review_83	తలలేని కాసురెడ్డికి వీపునే మోకాళ్ళు!,	ఇంటి కప్పు
telugu_huggingface_processed_review_84	గుత్తులు గుత్తులు మామిడి గుత్తులు మధ్యాహ్నానికి మాయం అవును, ఏమిటది?	ఇంటి ముందు కల్లాపు
telugu_huggingface_processed_review_85	చూచే వారే గానీ తీసే వారు లేరు.	ఇంద్ర ధనస్సు
telugu_huggingface_processed_review_86	శ్రీ రాముడు కూడ పట్టి వంచలేనిది, రంగు రంగులుగా ఒకే వరుసలో వచ్చునది, ‘కుక్కకు, నక్కకు పెళ్ళి’అనే సమయములో వచ్చునది. అదేమటో విప్పగలరా?	ఇంద్ర ధనస్సు
telugu_huggingface_processed_review_87	ధనము గాని ధనము ఏమి ధనము?	ఇంధనము, బంధనము
telugu_huggingface_processed_review_88	దాన్ని కొట్టాలంటే నీళ్లు తప్పక ఉండాల్సిందే?	ఈత
telugu_huggingface_processed_review_89	ఇక ఇక కాయ పక పక కాయ నేల పోయే కాయ నెత్తి కెక్కే కాయ,	ఈతకాయ
telugu_huggingface_processed_review_90	అడవిలో అక్కమ్మ తల విరబోసుకుంది?	ఈతచెట్టు
telugu_huggingface_processed_review_91	అడవిలో అక్కమ్మ జుట్టు విరబోసుకును కూర్చుంది?	ఈతచెట్టు
telugu_huggingface_processed_review_92	పొట్టలో వేలు, నెత్తి మీద రాయి.	ఉంగరం
telugu_huggingface_processed_review_93	చీకటి ఇంటిలో జడల దెయ్యము!	ఉట్టి
telugu_huggingface_processed_review_94	కోడి వేడినీళ్లు తాగితే ఏం చేస్తుంది?	ఉడకబెట్టిన గుడ్డు పెడుతుంది.
telugu_huggingface_processed_review_95	నామముంది కాని పూజారి కాదు. వాలముది కానీ కోతి కాదు.,	ఉడుత
telugu_huggingface_processed_review_96	చారల పాపడికి దూది కుచ్చు!,	ఉడుత
telugu_huggingface_processed_review_97	నామం ఉంటుంది కానీ పూజారి కాదు. వాలముంటుంది కాని కోతి కాదు.	ఉడుత.
telugu_huggingface_processed_review_98	తోక లేని పిట్ట తొంభై ఆమడలు పోతుంది?	ఉత్తరం
telugu_huggingface_processed_review_99	ఉత్తరానికి, దక్షిణానికి తేడా?	ఉత్తరం పోస్టు డబ్బాలో వేయగలం. దక్షిణాన్ని వేయలేం.
telugu_huggingface_processed_review_100	అందరికీ ఇష్టమైన కారం ఏమిటి?	ఉపకారం.
telugu_huggingface_processed_review_101	నీళ్లలో పుడుతుంది. నీళ్లలో పడితే చస్తుంది.,	ఉప్పు
telugu_huggingface_processed_review_102	ఆకులేని పంట,	ఉప్పు
telugu_huggingface_processed_review_103	నీటితో పంట - ఆకు లేని పంట	ఉప్పు
telugu_huggingface_processed_review_104	లక్ష్మి దేవి పుట్టకముందు ఆకు లేని పంట పండింది.ఇప్పటికీ ప్రతి ఇంట ఉంది.,	ఉప్పు
telugu_huggingface_processed_review_105	నీటి ఒరుగు - రాతి బురద	ఉప్పు-సున్నం
telugu_huggingface_processed_review_106	"కాయ, పువ్వు లేని పంట ఏ పంట?	ఉప్పుపంట
telugu_huggingface_processed_review_107	ఈడ ఢమ ఢమ ఆడ ఢమ ఢమ మద్ది రేవుల కాడ మరీ ఢమ ఢమ	ఉరుము
telugu_huggingface_processed_review_108	దుకాణములో కొంటారు. ముందర పెట్టుకొని ఏడుస్తారు.,	ఉల్లి గడ్డలు
telugu_huggingface_processed_review_109	అడ్డంగా కోస్తే చక్రం, నిలువుగా కోస్తే శంఖం	ఉల్లి పాయ
telugu_huggingface_processed_review_110	భూమిలో పుట్టింది - భూమిలో పెరిగింది - రంగేసుకొచ్చింది రామచిలుక,	ఉల్లిగడ
telugu_huggingface_processed_review_111	డబ్బుపెట్టి కొనడం ముందరగానే ఏడ్వడం.,	ఉల్లిగడ్డ
telugu_huggingface_processed_review_112	కాళ్ళు చేతులు లేని అందగత్తెకు బోలెడు దుస్తులు.,	ఉల్లిపాయ
telugu_huggingface_processed_review_113	ఈకల ఈరమ్మ ముళ్ళ పేరమ్మ సంతకు వెళితే అంతా కొనేవారే?	ఉల్లిపాయ
telugu_huggingface_processed_review_114	పొట్టి వాడికి ఒళ్లంతా బట్టలే ఎవరది?	ఉల్లిపాయ
telugu_huggingface_processed_review_115	కాళ్ళు చేతులు లేని తెల్లదొరకు బోలెడు దుస్తులు	ఉల్లిపాయ
telugu_huggingface_processed_review_116	అడ్డం కోస్తే చక్రం - నిలువు కోస్తే శంఖం,	ఉల్లిపాయ
telugu_huggingface_processed_review_117	నా శరీరాన్ని కోసినా నేను ఏడవను,కానీ నిన్ను ఏడిపిస్తాను ఎవరు నేను?	ఉల్లిపాయ
telugu_huggingface_processed_review_118	నలుగురు దొంగలపై ఒకటే రాయి	ఉసిరికాయ
telugu_huggingface_processed_review_119	లాగి విడిస్తేనే బ్రతుకు?	ఊపిరి
telugu_huggingface_processed_review_120	నేను దూది కన్నా తేలికగా ఉంటాను, ఎంత బలమైన మనిషి అయినా నన్ను ఒక ఐదు నిమిషాలు కూడా పట్టుకోలేడు, ఎవరు నేను?	ఊపిరి
telugu_huggingface_processed_review_121	చచ్చినోడు సంతకు పోవు!	ఎండు చేప
telugu_huggingface_processed_review_122	కాయ కాని కాయ	ఎండ్రకాయ
telugu_huggingface_processed_review_123	ఒక మనిషి భయంకరమైన వర్షం లో గొడుగు లేకుండా తడుస్తూ నిలబడి ఉన్నాడు కానీ అతని తల వెంట్రుక ఒక్కటి కూడా తడవలేదు ఎందుకు?	ఎందుకంటే అతని తల మీద వెంట్రుకలు లేవు కాబట్టి ( బట్ట తల)
telugu_huggingface_processed_review_124	తాళి గాని తాళి ఏమి తాళి?	ఎగతాళి
telugu_huggingface_processed_review_125	నువ్వు నీ కుడి చేతితో పట్టుకో గలిగేది నీ ఎడమ చేతితో పట్టుకోలేనిది ఏమిటది?	ఎడమ చేతి మోచెయ్యి
telugu_huggingface_processed_review_126	అడ్డగోడమీద బుడ్డ చెంబు, తోసినా ఇటుపక్క పడదు, అటు పక్క పడదు	ఎద్దు మూపురం
telugu_huggingface_processed_review_127	అడ్డగోడ మీద ముద్దపప్పు, అటు తోసినా పడదు. ఇటు తోసినా పడదు	ఎద్దు మూపురం
telugu_huggingface_processed_review_128	హుస్సేన్ సాబ్ ఉరకాలంటాడు ఖాదర్ సాబ్ కాదంటాడు,	ఎనుముపగ్గం
telugu_huggingface_processed_review_129	జిత్తెడు తోకున్న జివలగిరి మేక! ఆవుల కొండెక్కి, ఆకు మేసె!	ఎలుక
telugu_huggingface_processed_review_130	వైద్యులు ఆపరేషన్ చేస్తున్నప్పుడు ముఖానికి గుడ్డ ఎందుకు కట్టుకుంటారు?	ఎవరు చేశారో తెలియకూడదని
telugu_huggingface_processed_review_131	నాలుగు రోళ్ళు నడవంగా - రెండు చేటలు చెరగంగా - నోటినుండి పాము వ్రేలాడంగా - అందమైన దొరలు ఊరేగంగా,	ఏనుగు
telugu_huggingface_processed_review_132	గీతకు నలుగురు కూతుళ్లు ఉన్నారు ప్రతి కూతురుకు ఒక తమ్ముడు ఉన్నాడు,ఇంతకు గీతకు ఎంతమంది పిల్లలు ఉన్నారు?	ఐదుగురు
telugu_huggingface_processed_review_133	పచ్చ పచ్చల కుండ, పగడాల కుండ, లచ్చమ్మ చేయించు లక్ష వరాల కుండ	ఐరేని కుండ
telugu_huggingface_processed_review_134	డబ్బులిస్తే చాలు గుద్దుతాడు.	ఒడ్రమంగలి
telugu_huggingface_processed_review_135	డబ్బులిస్తానంటేనే దరువు వేస్తాడు.,	ఒళ్ళు పట్టేవాడు
telugu_huggingface_processed_review_136	స్థలం చుట్టూ పరిగెడుతోంది కాని కదలదు, ఏమిటది?	కంచె
telugu_huggingface_processed_review_137	మనకు కలలు ఎందుకు వస్తాయి.	కంటాం కాబట్టి
telugu_huggingface_processed_review_138	కిటకిట తలుపులు కిటారు తలుపులు ఎప్పుడు తీసిన చప్పుడు కావు.,	కంటి రెప్పలు
telugu_huggingface_processed_review_139	భుజం మీద ఉంటాడు దండెం మీద వ్రేలాడతాడు?	కండువ
telugu_huggingface_processed_review_140	వేస్తే సోకు! తీస్తే బోసి! ఏమిటి?	కండువ
telugu_huggingface_processed_review_141	టక్కు చూచుట కెంతో నిక్కు! జాఱి పడిందటే… పుటుక్కు!,	కండ్ల జోడు
telugu_huggingface_processed_review_142	ముక్కు మీద కెక్కు! చెవుల పైన నక్కు! జారిపడిందంటే పుటుక్కు! ఏమిటది?	కండ్లజోడు
telugu_huggingface_processed_review_143	చూచేవి చెప్పలేవు, చెప్పేది చూడ లేదు.	కండ్లు, నోరు
telugu_huggingface_processed_review_144	భూమిలో పెరిగిన బుల్లి చెంబు?	కందపిలక
telugu_huggingface_processed_review_145	నడుము సన్నపు నాగ లింగము! పోటు, పోటుకు బొబ్బలింగము!	కందురీగ
telugu_huggingface_processed_review_146	క్ష కారము చివరి స్థానము! క కారము మొదటి స్థానము! మరి నేనెవరిని?	కక్ష
telugu_huggingface_processed_review_147	తల్లి కూర్చొండు, పిల్ల పారాడు.	కడవ, చెంబు
telugu_huggingface_processed_review_148	పాప కాని పాప,	కనుపాప
telugu_huggingface_processed_review_149	కిట కిట తలుపులు, కిటారి తలుపు, ఎప్పుడు తీసిన చప్పుడు కావు, ఏమిటవి?	కనురెప్పలు
telugu_huggingface_processed_review_150	చిటపట చినుకులు చిటారు చినుకులు. ఎంతరాలినా చప్పుడు కావు.	కన్నీళ్లు
telugu_huggingface_processed_review_151	చిటపట చినుకులు చిటారి చినుకులు, ఎంత కురిసినా వరదలు రావు	కన్నీళ్ళు
telugu_huggingface_processed_review_152	గిన్నె, గిన్నె లో వెన్న, వెన్న లో నల్లద్రాక్ష?	కన్ను
telugu_huggingface_processed_review_153	నీటి పైన కలకలా కొమ్మమీద కిచకిచ,	కప్పలు-కోతులు
telugu_huggingface_processed_review_154	బాడి కాని బాడీ	కబడి, లంబాడీ
telugu_huggingface_processed_review_155	దేవుడు లేని మతం ఏమిటి?	కమతం
telugu_huggingface_processed_review_156	మాను కాని మాను,	కమాను
telugu_huggingface_processed_review_157	ఒక్క ఉద్యోగిపేరు నాల్గక్షరములు; మొదటి వర్ణము చెరపిన కదన మగును; మూడవది చెరుపగ హస్తమునకు చెల్లు; నట్టి ఉద్యోగి ఎవ్వడో అరచి చెప్పుడు.,	కరణం
telugu_huggingface_processed_review_158	రణం కాని రణం,	కరణం, శరణం, చరణం
telugu_huggingface_processed_review_159	ఆకువేసి అన్నం పెడితే ఆకు తీసి అన్నం తిన్నారు	కరివేపాకు
telugu_huggingface_processed_review_160	ప్రవహిస్తుంది కాని నీరుకాదు, పట్టుకుంటె ప్రాణం పోతుంది	కరెంటు
telugu_huggingface_processed_review_161	ఆకులేయగు నీరుత్రాగదు నేలని ప్రాకదు. ఏమిటా తీగ?	కరెంట్
telugu_huggingface_processed_review_162	చావిట్లో సద్దు కర్ర.,	కలం
telugu_huggingface_processed_review_163	సావిట్లో సద్దు కర్ర?	కలం
telugu_huggingface_processed_review_164	చూస్తే ఒకటి, చేస్తే రెండు, తలకూ, తోకకూ, ఒకటే టోపి చెప్పండి. ఇది చెప్పండి.	కలరు
telugu_huggingface_processed_review_165	వచ్చి పోయేవి రెండు! పోతే రానివి రెండు! ఏమిటి?	కలిమి, లేములు - మాన, ప్రాణములు
telugu_huggingface_processed_review_166	గుప్పెడు పిట్టకు బారెడు తోక?	కలువ పువ్వు
telugu_huggingface_processed_review_167	ఆకాశ పక్షి ఎగురుతూ వచ్చి, కడుపులో చొచ్చి లేపింది పిచ్చి.	కల్లు
telugu_huggingface_processed_review_168	ఈత చెట్టుకి ఇద్దరు బిడ్డలు?	కల్లు కుండలు
telugu_huggingface_processed_review_169	ముక్కు మీద కెక్కు. ముంద చెవులు నొక్కు. టక్కు నొక్కుల సోకు. జారిందంటే పుటుక్కు.,	కళ్లజోడు
telugu_huggingface_processed_review_170	ముద్దుగా నుండును, ముక్కుపైకెక్కు, చెవులు రెండూ లాగి చెంప నొక్కు దండి పండితులకు దారి చూపుట వృత్తి.	కళ్లజోడు.
telugu_huggingface_processed_review_171	అక్కా చెల్లెల అనుబంధం. ఇరుగూ పొరుగూ సంబంధం. దగ్గర, దగ్గర ఉన్నారు. దరికి చేరలేకున్నారు.	కళ్లు.
telugu_huggingface_processed_review_172	ముక్కు మీద కెక్కూ, ముందరి చెవులు నొక్కూ, టక్కుల నిక్కుల పొక్కూ, జారిందంటే పుటుక్కూ	కళ్ళజోడు
telugu_huggingface_processed_review_173	కిట కిట తలుపులు కిటారి తలుపులు ఎప్పుడు మూసిన చప్పుడు కావు?	కళ్ళు
telugu_huggingface_processed_review_174	అడవిలో పుట్టింది, మా ఇంటికి వచ్చింది. తాడేసి కట్టింది. తైతక్కలాడింది. కడవలో దూకింది. పెరుగులో మునిగింది. వెన్నంత తెచ్చింది.	కవ్వం
telugu_huggingface_processed_review_175	అడవిలో పుట్టింది, అడవిలో పెరిగింది. మా ఇంటికొచ్చింది తైతక్కలాడింది?	కవ్వం
telugu_huggingface_processed_review_176	సాయి గాని సాయి! ఏమి సాయి?	కసాయి
telugu_huggingface_processed_review_177	సన్న జాజుల కంటే చక్కని పూలు. సన్నని తీగలకు జల్లుగా పూయును?	కాకరపూలు
telugu_huggingface_processed_review_178	‘డాలు’ గాని డాలు! ఏమి డాలు?	కాగడాలు, అప్పడాలు
telugu_huggingface_processed_review_179	పురం కానిపురం	కాపురం, గోపురం
telugu_huggingface_processed_review_180	నల్లటి నీటిలో, తెల్లనీటిని పోసి, వెండి పలుకు లేస్తే అంతా త్రాగే వారే! ఏమిటవి?	కాఫీ, టీ
telugu_huggingface_processed_review_181	మందు కాని మందు?	కామందు
telugu_huggingface_processed_review_182	తలా తోకా ఉండి శరీరం లేనిది, ఏమిటి?	కాయిన్
telugu_huggingface_processed_review_183	ఒక గోడ ఇంకొక గోడను ఎక్కడ కలుస్తుంది?	కార్నర్లో/మూలలో
telugu_huggingface_processed_review_184	చేయడానికి ఇష్టపడానికి ధర్మం,	కాలధర్మం
telugu_huggingface_processed_review_185	కొనుక్కుందామనుకున్నా కొనలేనిది, అప్పుగా తీసుకొందామన్నా తీసికోలేనిది?	కాలము
telugu_huggingface_processed_review_186	గునగున నడిచేవి రెండు! గట్టెక్కి చూచేవి రెండు! ఆలంకించేవి రెండు! అర్ధము చెప్పేది ఒకటి!	కాళ్ళు, కళ్ళు, చెవులు, నోరు
telugu_huggingface_processed_review_187	చక చక పోయేవి రెండు. గట్టెక్కి చూచేవి రెండు అంది పుచ్చుకొనేవి రెండు. ఆలకించేవి రెండు.	కాళ్ళు, కళ్ళు, చేతులు, చెవులు.
telugu_huggingface_processed_review_188	గోడ నుండి బయటికి చూడ గలిగే పరిశోధన ఏమిటి?	కిటికీ
telugu_huggingface_processed_review_189	రాయి కాని రాయి,	కిరాయి, తురాయి, షరాయి, కీచురాయి
telugu_huggingface_processed_review_190	చిన్నచట్టిలో కమ్మటి కూర!,	కిళ్ళీ
telugu_huggingface_processed_review_191	శిబి, కర్ణులార్జించిన చెలువ ఏది?	కీర్తి
telugu_huggingface_processed_review_192	వస్తే పోనివి రెండు! పోతే రానివి రెండు! ఏమిటి?	కీర్తి, అపకీర్తి - పరువు, ప్రతిష్ట
telugu_huggingface_processed_review_193	బుడగకు బుక్కెడు నెత్తురు?	కుంకుమ
telugu_huggingface_processed_review_194	జానెడు ఇంట్లో, మూరెడు కర్ర?	కుండలో గరిటె.
telugu_huggingface_processed_review_195	దోసెడు ఇంట్లో, మూరెడు కర్ర?	కుండలో గరిటె.
telugu_huggingface_processed_review_196	గీయలేని కోణం ఏమిటి?	కుంభకోణం.
telugu_huggingface_processed_review_197	విశ్వాసమునకు ప్రతినిధిని నేను! విశ్వాసహీనుని చూచి, ‘ నీకంటే అదే నయమని’ అంటారు. మరి నేనెవరిని?	కుక్క
telugu_huggingface_processed_review_198	ఉద్యోగం సద్యోగం లేదు ఊరంతా వ్యాపకమే	కుక్క
telugu_huggingface_processed_review_199	హడవిడిగా తిరిగే రంగయ్య -అమ్దరి ఇండ్లు నీవేనయ్యా	కుక్క
telugu_huggingface_processed_review_200	ఆ ఇంటికి ఈ ఇంటికి లాలా బుడిగి?	కుక్కపిల్ల
telugu_huggingface_processed_review_201	దున్నలేని హలం?	కుతూహలం.
telugu_huggingface_processed_review_202	ఇంటివెనక వెంపలి చెట్టు, యే కాయ కాయమంటే, ఆ కాయే కాస్తుంది	కుమ్మరి సారె
telugu_huggingface_processed_review_203	ఇంటివెనుక వెంపలిచెట్టు ఏకాయ కాయమంటే, ఆ కాయ కాస్తుంది.	కుమ్మరిసారె
telugu_huggingface_processed_review_204	కాళ్ళున్నా పాదములు లేనిది?	కుర్చీ
telugu_huggingface_processed_review_205	భోజనం సహింపలేదు, గుంజకదలాడుచున్నావెందుకు?	కూరలేదు
telugu_huggingface_processed_review_206	ఒంటి కంటివాడు ప్రాణం లేని వాడు ప్రతి సృష్టి చేస్తాడు.,	కెమెరా
telugu_huggingface_processed_review_207	చేపల్ని తినే రాయి ఏమిటి?	కొక్కిరాయి.
telugu_huggingface_processed_review_208	పెట్టుకుంటూనే పట్టి చూచుకోవాలి?	కొప్పు
telugu_huggingface_processed_review_209	"చెక్కని స్తంభం చేతికందదూ, చెయ్యని కుండా పొయ్యని నీళ్ళు చెయ్య సున్నం – తియ్యని బెల్లం	కొబ్బరి
telugu_huggingface_processed_review_210	కొప్పుంది కాని జుట్టు లేదు, కళ్లున్నాయి కానీ చూపు లేదు?	కొబ్బరి కాయ
telugu_huggingface_processed_review_211	ఆ వీధిరాజుకి కొప్పుంది. జుట్టలేదు. కళ్లున్నాయి చూపులేదు,	కొబ్బరి కాయ
telugu_huggingface_processed_review_212	గుడి! గుడికి మూడు నేత్రములు! ఈ గుడిలో లింగము లేదు గానీ, గంగ ఉన్నది.	కొబ్బరి కాయ
telugu_huggingface_processed_review_213	నేలమొలవనితుంగ, కుమ్మరివాడు చెయ్యని కుండ, చాకలివాడు చెయ్యని చలువ, వానకురవని నీళ్ళు	కొబ్బరి కాయ
telugu_huggingface_processed_review_214	సూర్యుడు చూడని గంగ, చాకలి ఉతకని మడుగు	కొబ్బరి కాయ నీళ్ళు
telugu_huggingface_processed_review_215	పడమట ఓ రాజుకి జుట్టుంది. కొప్పుంది. కన్నులున్నాయి. చూపు లేదు.	కొబ్బరి కాయ.
telugu_huggingface_processed_review_216	మూడు కళ్ళుంటాయి కానీ ఈశ్వరుడు కాదు,	కొబ్బరి కాయ.
telugu_huggingface_processed_review_217	రాజ మందిరము చిన్నదానా! రాఘవయ్య కోడలా! చేద వెయ్యకుండా, తియ్యకుండా, దాహమునకు నీరు తేవె!	కొబ్బరి నీరు
telugu_huggingface_processed_review_218	కడుపునిండానీరు! ఒట్టిగానే ఊరు! కొట్టగానే పరారు!,	కొబ్బరి బోండాము
telugu_huggingface_processed_review_219	బండకు కొడితే వెండి ఊడుతుంది?	కొబ్బరికాయ
telugu_huggingface_processed_review_220	ఆ వీధిరాజుకి కొప్పంది- జుట్టులేదు. కళ్లున్నాయి చూఃపులేదు?	కొబ్బరికాయ
telugu_huggingface_processed_review_221	చెయ్యని కుండ, పొయ్యని నీరు, వెయ్యని సున్నము, తియ్యగ నుండు	కొబ్బరికాయ
telugu_huggingface_processed_review_222	"గుడిచుట్టూ తిరిగి, గుళ్ళో వుచ్చపోసె	కొబ్బరికాయ
telugu_huggingface_processed_review_223	హనుమంతుడి భార్య గొప్ప ధనవంతురాలు. తట్టెడు సొమ్ములు పెట్టుకొని తలవంచుతుంది?	కొర్ర కంకి
telugu_huggingface_processed_review_224	భూమిమీద పొర్లాడుతుంది, గాలికి నోరావలించి గబుక్కున మింగుతుంది, నడినెత్తి మీద మంట మండిస్తుంది, అది ఏమిటో చెప్పుకోండి పిల్లలూ	కొలిమితిత్తి
telugu_huggingface_processed_review_225	తెల్లకోటు తొడుక్కున్న ఎర్రముక్కు దొర,	కొవ్వొత్తి
telugu_huggingface_processed_review_226	చుట్టింటికి మొత్తే లేదు	కోడి గుడ్డు
telugu_huggingface_processed_review_227	పిటాపురం చిన్నవాడా పిట్టల వేటగాడా బ్రతికిన పిట్టను కొట్టవద్దు. చచ్చిన పిట్టను తేనూవద్దు. కూరకు లేకుండా రావద్దు. ఏమి కూర.	కోడి గ్రుడ్డు
telugu_huggingface_processed_review_228	మా బావ బజారుకెళ్ళి తొడిమలేని వంకాయ తెచ్చాడు?	కోడి గ్రుడ్డు
telugu_huggingface_processed_review_229	లోన బంగారము! బయట వెండి! ఏమిటి?	కోడి గ్రుడ్డు
telugu_huggingface_processed_review_230	కీ ఇచ్చే అవసరము లేకుండా అడిగినా, అడగకున్నా, కరెక్ట్ గా టైం చెప్పేస్తుంది. ఏమది?	కోడి పుంజు
telugu_huggingface_processed_review_231	ఒక కోడి పుంజు దగ్గర రెండు తెల్ల గుడ్లు రెండు ఎర్ర గుడ్లు వున్నాయి వాటిలో దానికి సంభందించినవి ఏవి?	కోడి పుంజు అసలు గుడ్లు పెడుతుందా
telugu_huggingface_processed_review_232	గుండు మీద గుండు ఎంతపెట్టిన నిలవదు?	కోడిగ్రుడ్డు
telugu_huggingface_processed_review_233	పొడల పొడల బువ్వ, పొంకమయిన గువ్వ, బువ్వలోకి మొవ్వ, పురుగులు తినే అవ్వ, రాజులు పొడిచే చివ్వ, రాత్రి తెలిపే రవ్వ, నున్ననైన గువ్వ, నూకలు తినే తవ్వ	కోడిపుంజు
telugu_huggingface_processed_review_234	నేను చిన్నగా ఉన్నప్పుడు పొడవుగా ఉంటాను కానీ కాలం గడిచే కొద్దీ పొట్టిగా అవుతాను ఎవరు నేను?	క్యాండిల్
telugu_huggingface_processed_review_235	అడవిలో పుట్టింది, అడవిలో పెరిగింది, చెంబులో నీళ్ళన్ని, చెడ త్రాగుతుంది	గంధపు చెక్క
telugu_huggingface_processed_review_236	అడవిలో పుట్టింది, అడవిలో పెరిగింది, చెంబులో నీళ్ళన్నీ చెడతాగుతుంది.	గంధపుచెక్క
telugu_huggingface_processed_review_237	అడుగులు ఉన్నా కాళ్ళు లేనిది?	గజం బద్ద
telugu_huggingface_processed_review_238	ఇంటికి అందం?	గడప
telugu_huggingface_processed_review_239	అడవిలో పుట్టింది, అడవిలో పెరిగింది; మా ఇంటి కొచ్చింది మహలక్ష్మి. ఎవరు?	గడప
telugu_huggingface_processed_review_240	దీనికి చేతులు ఉంటాయి గాని చప్పట్లు కొట్టలేదు,ఏమిటది?	గడియారం
telugu_huggingface_processed_review_241	టిక్కు టిక్కు బండి! టక్కులాడి బండి! సాగిపోవు బండి! హాల్ట్ లేని బండి! అదేమిటి?	గడియారము
telugu_huggingface_processed_review_242	తమ్ముడు కుంటుతూ, కుంటుతూ మైలు నడిచేసరికి అన్న పరుగెత్తుకుంటూ పన్నెండు మైళ్ళు నడుస్తాడు.	గడియారములోని ముళ్ళు
telugu_huggingface_processed_review_243	విత్తనము లేకుండా, మొలిచేది ఏమిటి?	గడ్డము
telugu_huggingface_processed_review_244	మత్తు కాని మత్తు,	గమ్మత్తు.. కిమ్మత్తు
telugu_huggingface_processed_review_245	గూబ - గూటిలో! తోక – చేతిలో!	గరిటె
telugu_huggingface_processed_review_246	శ్రీ విష్ణువు మోయుచు తిరిగెడు పక్షి?	గరుడ పక్షి
telugu_huggingface_processed_review_247	వస్తూకేక లేస్తుండు! వేస్తూ పోతుండు! ఎవరు?	గాజులసెట్టి
telugu_huggingface_processed_review_248	ఆకాశమంతా అల్లుకు రాగా: చేటెడు చెక్కులు చెక్కుకు రాగా: కడివెడు నీరు కారుకు రాగా: అందులో ఒక రాజు ఆడుతుంటాడు.	గానుగ
telugu_huggingface_processed_review_249	ఆకాశాన పటం.. కింద తోక.,	గాలిపటం
telugu_huggingface_processed_review_250	వ్రేలిమీద నుండు వెండుంగరము కాదు - వ్రేలిమీద నుండి నేలజూచు, అంబరమున దిరుగు నది యేమిచోద్యమో - విశ్వదాభిరామ వినురవేమ !	గాలిపటం
telugu_huggingface_processed_review_251	‘టూరు’ గాని టూరు, ఏమి టూరు?	గుంటూరు, ఇంటూరు
telugu_huggingface_processed_review_252	తల ఉన్నా కళ్ళు లేనిది?	గుండు సూది
telugu_huggingface_processed_review_253	నాకు మీ చేయి తగిలితే నేను ఊరుకోను. ఎలుగెత్తి అరుస్తాను, దైవమును పిలుస్తాను. నేనెవరిని?	గుడిగంట
telugu_huggingface_processed_review_254	మనం దానిని వాడాలి అంటే దానిని ఖచ్చితంగా పగలగొట్టాలి ఏంటది?	గుడ్డు
telugu_huggingface_processed_review_255	చిన్నమిద్దెలో చింతపండు?	గుబిలి
telugu_huggingface_processed_review_256	బావిలో చింత పండు?	గుబిలి
telugu_huggingface_processed_review_257	లోతు బావిలో జారికి బెల్లం?	గుబిలి
telugu_huggingface_processed_review_258	ఆ పక్క చూస్తే ఎర్ర టోపీ ఈ పక్క చుస్తే నల్ల టోపీ నేనెవరు?	గురిగింజ
telugu_huggingface_processed_review_259	వళ్ళంతా ముళ్ళు. వాసన ఘుమఘుమ?	గులాబి
telugu_huggingface_processed_review_260	నల్ల బండ క్రింద నలుగురు దొంగలు?	గేదె, గేదె పొదుగు
telugu_huggingface_processed_review_261	రచ్చబండ క్రింద నలుగురు దొంగలు?	గేదెపొదుగు
telugu_huggingface_processed_review_262	ఎండా లేదా వానొస్తే గాని బయట అడుగుపెట్టనిది	గొడుగు
telugu_huggingface_processed_review_263	వానొస్తే పడగ విప్పు - ఎండ వస్తే పడగ విప్పు - గాలి వేస్తే గడ గడ వణుకు,	గొడుగు
telugu_huggingface_processed_review_264	ఇంటిలో మొగ్గ, వీధిలోపువ్వు	గొడుగు
telugu_huggingface_processed_review_265	మూలన కూర్చుంటుంది. ఎండొచ్చినా, వానొచ్చినా బయటకు బయలుదేరుతుంది.	గొడుగు.
telugu_huggingface_processed_review_266	అడవిలో ఆంబోతు రంకె వేస్తుంది?	గొడ్డలి
telugu_huggingface_processed_review_267	అలాము కొండకు సలాము కొట్టు.,	గొడ్డలి
telugu_huggingface_processed_review_268	మారు కథ మంకెన్న! నీకు నాకు లంకెన్న!	గొళ్ళెము
telugu_huggingface_processed_review_269	రేయీ, పగలూ నడిచింది. చేయీ, చేయీ కదిలింది. వేళా, పాళా చెపుతుంది. వున్నచోటనే పడివుంది.	గోడ గడియారము
telugu_huggingface_processed_review_270	అరచేతిలో అద్దం.. ఆరు నెలల యుద్ధం	గోరింటాకు
telugu_huggingface_processed_review_271	అర చేతిలో కుంకుమ అందమైన కుంకుమ బీరాకు కుంకుమ బిగువైన కుంకుమ,	గోరింటాకు
telugu_huggingface_processed_review_272	అరచేతిలో కుంకుమ - గోటిమీద కుంకుమ - బీరాకు కుంకుమ - అందాల కుంకుమ,	గోరింటాకు
telugu_huggingface_processed_review_273	మారుతట్టు మల్లప్ప, నీ ముడ్డి గిల్లప్ప	గోరుచిక్కుడుకాయ
telugu_huggingface_processed_review_274	పగలు కూడా కనపడే నైట్ ఏమిటి?	గ్రానైట్
telugu_huggingface_processed_review_275	జీవం ఉంది కాని కదలలేదు	గ్రుడ్డు
telugu_huggingface_processed_review_276	పుట్టినా కదలనిది ఏది?	గ్రుడ్డు
telugu_huggingface_processed_review_277	నాలో నదులున్నాయి గానీ, మ్యాప్‌ను కాను. గుండ్రంగా వుంటాను గానీ, బంతిని కాను. నాలోనే సర్వము ఉన్నది గానీ, దేవుడ్ని కాను.	గ్లోబ్
telugu_huggingface_processed_review_278	అన్ని వేళ్ళు ఉన్నా నేను చేతిని కాను,మరి నేను ఎవరు?	గ్లోవ్స్
telugu_huggingface_processed_review_279	అమ్మతమ్ముడినికాను, కానీ నేను మీకు మేనమాను.	చందమామ
telugu_huggingface_processed_review_280	అమ్మ తమ్ముడిని కాదు. నేను మీ అందరికీ మేనమామనే?	చందమామ
telugu_huggingface_processed_review_281	గంపెడు శనగల్లో ఒక గులకరాయి?	చందమామ
telugu_huggingface_processed_review_282	అంద చందాల వాడు రోజుకో ఆకారం చివరికి నిరాకారం లేదా నిండు సున్న	చందమామ
telugu_huggingface_processed_review_283	పుట్టెడు శనగలలో ఒకటే రాయి.,	చందమామ
telugu_huggingface_processed_review_284	పుట్టేటప్పుడు కొమ్ములుంటాయి గానీ, రాక్షసుడను కాను. పెరిగే కొద్దీ గుండ్రముగా ఔతాను గానీ, గోళమును కాను. ఎప్పుడూ తిరుగుతుంటాను గానీ, గడియారమును కాను. మరి నేనెవరిని?	చందమామ
telugu_huggingface_processed_review_285	చుక్కల చుక్కల గుర్రాలెక్కి, సూటి కర్రా చేతా బట్టి, ఆకుల్లేని అరణ్యానికి, రాకుమారుడు వేటకు వెళ్ళె	చందమామ
telugu_huggingface_processed_review_286	ముందుగా పలకరిస్తుంది మళ్ళీ తిడుతుంది తర్వాత మర్యాదగా అంటుంది,	చందమామ!
telugu_huggingface_processed_review_287	గంప గులకరాళ్ళలో ఒక చెకుముకి రాయి?	చంద్రుడు
telugu_huggingface_processed_review_288	భూ మాతకు ముద్దు బిడ్డ. ఆకాశపు జున్ను గడ్డ. రాత్రి వేళ రాజరికం. పగలయితే పేదరికం.,	చంద్రుడు
telugu_huggingface_processed_review_289	చిన్న కంచం - పెద్ద కంచం, నూక బువ్వ - నూరు బొట్లు	చంద్రుడు - మబ్బు, నక్షత్రాలు - వాన
telugu_huggingface_processed_review_290	ఈరు బావి మీద ఇల్లెక్కి చదలు పోయి చెన్న పట్నం చేరి?	చదలు, జాబు
telugu_huggingface_processed_review_291	నట్టింట్లో నలుగురు దొంగలు?	చనుకట్ట
telugu_huggingface_processed_review_292	శివరాత్రికి శివ శివా అంటూ పోయేది?	చలి
telugu_huggingface_processed_review_293	శివరాత్రికి చంకలెత్తనీయదు.. ఏమిటదీ?	చలి
telugu_huggingface_processed_review_294	అడవిలో పుట్టింది, అడవిలో పెరిగింది, మా ఇంటికొచ్చింది, తైతక్కలాడింది	చల్లకవ్వం
telugu_huggingface_processed_review_295	సందకాడ లగ్గమాయె! కాని పొత్తు గర్భమాయె! కోడి కూతకు కొడుకు పుట్టె! పొద్దు పొడవ పేరు కొచ్చె!,	చల్లకుండ
telugu_huggingface_processed_review_296	ఊళ్ళో కలి, వీధిలో కలి, ఇంట్లో కలి, ఒంట్లో కలి.	చాకలి, రోకలి, వాకలి, ఆకలి.
telugu_huggingface_processed_review_297	చాచుకొని, సావిట్లో పండుకొనే ముసలమ్మ! ముడుచుకొని, మూల నిలబడుతుంది.	చాప
telugu_huggingface_processed_review_298	శ్రీ రాముల ఇంటి వెనుక శ్రీవణము చెట్టు! కాస్తుంది, పూస్తుంది. వాసన వుండదు.	చింతకాయ
telugu_huggingface_processed_review_299	ఆకాశాన కొడవళ్ళు వ్రేలాడుతున్నాయి?	చింతకాయలు
telugu_huggingface_processed_review_300	దాని పువ్వు పూజకు రాదు. దాని ఆకు దొప్పకు రాదు, దాని పండు అందరు కోరు?	చింతపండు
telugu_huggingface_processed_review_301	తోలు నలుపు, తింటే పులుపు.	చింతపండు
telugu_huggingface_processed_review_302	తోలు నలుపు, తింటే పులుపు అది ఏమిటో తెలుపు?	చింతపండు
telugu_huggingface_processed_review_303	నాగస్వరానికి లొంగని త్రాచు. నిప్పంటిచగానే తాడెత్తు లేస్తుంది.,	చిచ్చు బుడ్డి
telugu_huggingface_processed_review_304	ఐదుగురు భర్తలు ఉంటారు కానీ ద్రౌపది కాదు? ఐదుగిరిలో చిన్నోడు, పెళ్ళికి మాత్రం పెద్దోడు	చిటికెన వేలు
telugu_huggingface_processed_review_305	ఆకు అలము కాదుకాని ఆకుపచ్చన, కాయసున్నం కాదుకాని నోరు ఎర్రన	చిలుక
telugu_huggingface_processed_review_306	ఎంత ఎక్కువ ఉంటే అంత తక్కువ కనబడుతుంది,ఏంటది?	చీకటి
telugu_huggingface_processed_review_307	ఇల్లంతా తిరుగుతుంది, మూలన కూర్చుంటుంది	చీపురు
telugu_huggingface_processed_review_308	ఇల్లంతా తిరిగి మూల కూర్చుంది?	చీపురు కట్ట
telugu_huggingface_processed_review_309	వందమంది అన్నదమ్ములు - కట్టి పడేస్తే - కావలసినప్పుడు కదులుతారు - దుమ్ము ధూళీ దులుపుతారు,	చీపురు కట్ట
telugu_huggingface_processed_review_310	నూరుగురు అన్నదమ్ములకు ఒకటే మొలతాడు	చీపురు తాడు
telugu_huggingface_processed_review_311	బాటకు బంధం, నల్లపూసల అందం?	చీమల బారు
telugu_huggingface_processed_review_312	ఆ కొండకు ఈ కొండకు ఇనుప సంకెళ్ళు?	చీమలబారు
telugu_huggingface_processed_review_313	పీస్ పీస్ పిట్ట, నేల కేసి కొట్ట	చీమిడి
telugu_huggingface_processed_review_314	రాజుగారి తోటలో రోజాపూజలు. చూసేవారేగాని, లెక్కించేవారు లేరు.	చుక్కలు
telugu_huggingface_processed_review_315	హరీ అనకుండానే చచ్చేది?	చెట్టు
telugu_huggingface_processed_review_316	కనేవారులేరు! పెంచేవారులేరు! దానంతటదే పుట్టు! అదే చచ్చు!	చెదలు
telugu_huggingface_processed_review_317	ఆమడ నడిచి అల్లుడొస్తే, మంచం కింద ఇద్దరూ, గోడ మూల ఒకరూ, దాగుకున్నారు.	చెప్పుల జోడు, చేతి కర్ర
telugu_huggingface_processed_review_318	ఆమడదూరం నుంచి అల్లుడొస్తే మంచంకింద ఇద్దరు గోడమూల ఒకరూ దాక్కున్నారు.,	చెప్పుల జోడు,చేతికర్ర
telugu_huggingface_processed_review_319	నోరు లేకపోయినా కరిచేవి?	చెప్పులు
telugu_huggingface_processed_review_320	మంచము క్రింద మామా! ఊరికి పోదాము రావా?	చెప్పులు
telugu_huggingface_processed_review_321	ఊరంతా నాకి మూల కూర్చుండేది - యేది?	చెప్పులు
telugu_huggingface_processed_review_322	మంచం కింద మావయ్యా, ఊరికి పోదాం రావయ్యా	చెప్పులు
telugu_huggingface_processed_review_323	చిన్న కాయ! నీ మీదున్న కాయ!,	చెమట కాయ
telugu_huggingface_processed_review_324	కంటికి నలుపు అందం, నాలుకకి తీపి అందం?	చెరకు
telugu_huggingface_processed_review_325	ఈనదు కట్టదు కడుపు నిండితే ప్రజల కింత ఫలమిచ్చు,	చెరువు
telugu_huggingface_processed_review_326	అందరూ భయపడే బడి ఏమిటి?	చేతబడి.
telugu_huggingface_processed_review_327	పాతాల మేడకు పది కూసాలు. ఊపితే ఊగుతాయి. పీకితే రావు.	చేతి వేళ్లు
telugu_huggingface_processed_review_328	ఈరు మాను పోయి ఇల్లెక్కె?	చొప్పదంటు
telugu_huggingface_processed_review_329	‘వరి’ గాని వరి! ఏమి వరి?	జనవరి
telugu_huggingface_processed_review_330	ఇల్లంతాఎలుక బొక్కలు..,	జల్లెడ
telugu_huggingface_processed_review_331	అరచేతిలో 60 నక్షత్రాలు?	జల్లెడ
telugu_huggingface_processed_review_332	ఇల్లల్లా ఎలుక బొక్కలు?	జల్లెడ
telugu_huggingface_processed_review_333	మల్లపు గుర్రానికి ఒళ్ళంతా రంధ్రాలు?	జల్లెడ
telugu_huggingface_processed_review_334	తెల్లని బంతి చల్లని బంతి అందని బంతి ఆడని బంతి,	జాబిలి
telugu_huggingface_processed_review_335	ఓ ఆకు..మర్రి ఆకు.. కాయ.. మామిడి కాయ.. పువ్వు మల్లెపువ్వు	జిల్లేడు
telugu_huggingface_processed_review_336	కాయ కజ్జికాయ, ఆకేమో తమలపాకు?	జిల్లేడుకాయ
telugu_huggingface_processed_review_337	అడవి లో మాను ఎంత కోసినా ఎదుగుతుంది	జుట్టు
telugu_huggingface_processed_review_338	నున్నటి బండమీద నూగులను ఎండబోస్తే, నాలుక లేని భీముడొచ్చి, నాకి పోయాడు.	జుట్టు కత్తిరించే కత్తి
telugu_huggingface_processed_review_339	గడంత సానికి - ముంతంత కొప్పు!,	జొన్నకంకి
telugu_huggingface_processed_review_340	హనుమంతరావు గారి పెండ్లాం గుణవమ్తురాలు.తెట్టెడు సొమ్ములు పెట్టుకొని తలవంచుకొన్నది.	జొన్నకంకి
telugu_huggingface_processed_review_341	వంకలు జాచి జింకలు బెదురు.,	జొళ్లు
telugu_huggingface_processed_review_342	"క్షమించుట తప్ప, నాకేమీ తెలియదు. మరి నేనెవరిని?	జ్ఞాని
telugu_huggingface_processed_review_343	మనం ఆరబెడుతున్న కొద్దీ తడిగా అయ్యేది ఏమిటి?	టవల్
telugu_huggingface_processed_review_344	చూస్తే చిన్నోడు, వాడి ఒంటి నిండా నార బట్టలు?	టెంకాయ
telugu_huggingface_processed_review_345	శంఖు.. శంఖులో తీర్థం.. తీర్థంలో మొగ్గ,	టెంకాయ
telugu_huggingface_processed_review_346	చెయ్యని కుండ పొయ్యని నీరు, పెట్టని సున్నం?	టెంకాయ
telugu_huggingface_processed_review_347	శంఖులో పెంకు, పెంకులోతీర్థము, తీర్థములో మొగ్గ?	టెంకాయ
telugu_huggingface_processed_review_348	సూర్యుడు చూడని మడుగు! చాకలి తాకని గంగ!,	టెంకాయ
telugu_huggingface_processed_review_349	ఆకాశాన అంబు, అంబులో చెంబు, చెంబులో చారెడు నీళ్ళు	టెంకాయ
telugu_huggingface_processed_review_350	శంకు లో పెంకు,పెంకు లో తీర్థం,తీర్థం లో మొగ్గ	టెంకాయ
telugu_huggingface_processed_review_351	చెయ్యని కుండ పొయ్యని నీళ్ళు, వెయ్యని సున్నం తియ్యగ నుండు.	టెంకాయ .
telugu_huggingface_processed_review_352	అణాకాణి మేక, దాని బొచ్చు నువ్వు పీక	టెంకాయ పీచు
telugu_huggingface_processed_review_353	ఇక్కడ ఉంటుంది - అక్కడ ఉంటుంది -పిలిస్తె పలుకుతుంది - మనలాగే మాట్లాడుతుంది,	టెలిఫోన్
telugu_huggingface_processed_review_354	డిల్లీలో పాటను లండన్ లో వినిపిస్తుంది. మాస్కో లో నాటకాన్ని న్యూయర్క్ లో చూపిస్తుంది.	టెలివిజన్
telugu_huggingface_processed_review_355	దీనికి కాళ్ళు ఉంటాయి గాని నడవలేదు,ఏమిటది?	టేబుల్
telugu_huggingface_processed_review_356	హర్మోనియంకూ, నాకూ తేడా ఉండదు. అది శబ్దము చేస్తుంది. నేనునూ శబ్దము చేస్తాను. దాని ఫలితము అశాశ్వతము! నా ఫలితము శాశ్వతము! మరి నేనెవరిని?	టైప్ రైటర్
telugu_huggingface_processed_review_357	నీరు లేని వెల్ ఏమిటి?	ట్రావెల్
telugu_huggingface_processed_review_358	ఓకే చోదకుడితో నడిచే బస్సు,	డబుల్ డెక్కర్ బస్సు
telugu_huggingface_processed_review_359	మనుషులు నన్ను తయారుచేస్తారు, నన్ను దాచుకుంటారు,,నన్ను మార్చుకుంటారు నన్ను పెంచుకుంటారు ఎవరు నేను?	డబ్బు
telugu_huggingface_processed_review_360	నిన్న కన్నా ఈ రోజు ఎక్కడ ముందు వస్తుంది?	డిక్షనరీలో
telugu_huggingface_processed_review_361	నేను ఎవరిని ప్రశ్నించను కానీ నాకు అందరూ సమాధానం చెప్పారు ఎవరు నేను?	డోర్ బెల్
telugu_huggingface_processed_review_362	ఆడ గణ గణ ఈడ గణ గణ మద్దెమ్మ గుడి కాడ మరీ గణ గణ,	డోలు
telugu_huggingface_processed_review_363	పిల్లలు ఉండని స్కూల్ ఏమిటి?	డ్రైవింగ్ స్కూల్
telugu_huggingface_processed_review_364	తాగలేని రమ్ ఏమిటి?	తగరం.
telugu_huggingface_processed_review_365	పొంచిన దెయ్యం పోయిన చోటికల్లా వస్తుంది?	తన నీడ
telugu_huggingface_processed_review_366	ఇంతింత ఆకు, ఇంపైన ఆకు, రాజుల మెచ్చిన రత్నాల ఆకు?	తమలపాకు
telugu_huggingface_processed_review_367	కొండ మీద బండరాయి - రాతి మీద లోతు బావి - బావిలోపల ఊరే జల - ఆడే పాము,	తల - నోరు ఉమ్ము - నాలుక
telugu_huggingface_processed_review_368	శెలలో శెల్వరాజు, పట్నాన పచ్చ రాయి, పేలూరు తెల్ల రాయి, నెల్లూరు నల్ల రాయి, నాలుగున్నూ చేర్చి ముప్పయి ఇద్దరు,తొక్కగ కారింది రక్తం	తాంబూలం
telugu_huggingface_processed_review_369	చిట్టి పిడతలో మూడు కూరలు!,	తాంబూలము
telugu_huggingface_processed_review_370	ఎండకు ఎండి, వానకు తడిసి, మూల నక్కి కూర్చుంది.	తాటాకు గొడుగు.
telugu_huggingface_processed_review_371	ముగ్గురు సిపాయిలకి ఒకటే టోపీ?	తాటి కాయ
telugu_huggingface_processed_review_372	ఇక్కడ నుండి చూస్తే ఇనుముగా నుండు దగ్గరకు పోతే పండుగా నుండు తింటే తీపిగా నుండు,	తాటి పండు
telugu_huggingface_processed_review_373	గుడి బయట గడుసు, లోన మొత్తన, నీరు చిక్కన!	తాటి ముంజ
telugu_huggingface_processed_review_374	కుడితి తాగదు, మేత మేయదు, కానీ కుండెకు పాలిస్తుంది?	తాటిచెట్టు
telugu_huggingface_processed_review_375	చూస్తే సురాలోకం - పడితే నీటికుండ - పగిలితే పచ్చ బంగారం,	తాటిపండు
telugu_huggingface_processed_review_376	ఇక్కడి నుంచి చూస్తే యినుము; దగ్గరికి పోతే గుండు; పట్టి చూస్తే పండు; తింటే తీయగనుండు.	తాటిపండు.
telugu_huggingface_processed_review_377	కుడితి తాగదు. మేత మేయదు. కాని కుండెకు పాలు ఇస్తుంది.,	తాడి చెట్టు
telugu_huggingface_processed_review_378	ఈనదు, పొర్లదు, బంధం వేస్తే బిందెల పాలిస్తుంది?	తాడిచెట్టు
telugu_huggingface_processed_review_379	కడుపులేనిది నీళ్లుతాగింది, రోజూ చెంచాడు పాలిస్తుంది!	తాడిచెట్టు
telugu_huggingface_processed_review_380	ఇద్దరు కొడుకులు ఇద్దరు తండ్రులూ ఒక కారులో ప్రయాణిస్తున్నారు కానీ ఆ కారులో ముగ్గురు వ్యక్తులు మాత్రమే ఉన్నారు ఎలాగా?	తాత,తండ్రి మరియు కొడుకు వున్నారు
telugu_huggingface_processed_review_381	పెంకు మీద పక్షి పేరు చెప్పవే కమలాక్షి,	తాబేలు
telugu_huggingface_processed_review_382	ఇంతింతాకు ఇస్తరాకు, రాజులు మెచ్చిన రత్నాలాకు.	తామలపాకు.
telugu_huggingface_processed_review_383	సూది వెళ్ళి చుక్కలను తాకింది. ఏమిటి?	తారాజువ్వ
telugu_huggingface_processed_review_384	తోకలో నిప్పు పెడితే ఆకాశానికి ఎగురుతుంది - అక్కడ పగులుతుంది, కింద పడుతుంది	తారాజువ్వ
telugu_huggingface_processed_review_385	తోకాయగారికి కోపం వస్తే ఆకాశానికి పరుగులు తీస్తాడు,	తారాజువ్వ
telugu_huggingface_processed_review_386	ఆ బాబా ఈ బాబు పోట్లాడితే కూన రాములు తగువు తీర్చాడు?	తాళం
telugu_huggingface_processed_review_387	కదలలేడు, కానీ కావలికి గట్టివాడు	తాళం
telugu_huggingface_processed_review_388	పోకంత పొట్టోడు. ఇంటికి గట్టోడు.,	తాళం కప్ప
telugu_huggingface_processed_review_389	ఇనుప ముద్దోడు కానీ ఇంటికి గట్టోడు	తాళం బుర్ర
telugu_huggingface_processed_review_390	నల్లని షర్టువాడు, కావలికి గట్టివాడు.	తాళం.
telugu_huggingface_processed_review_391	జాజికాయ కొట్లాడుతుంది ఎలక్కాయ విడిపిస్తుంది.,	తాళంచెవి
telugu_huggingface_processed_review_392	బొట్టు కాని బొట్టు,	తాళి బొట్టు, పచ్చబొట్టు
telugu_huggingface_processed_review_393	బొట్టు కాని బొట్టు ఏమి బొట్టు?	తాళిబొట్టు
telugu_huggingface_processed_review_394	రాతి శరీరం - మధ్యలో నోరు - తిరుగుతూ ఉంటుంది. తింటూ కక్కుతుంది,	తిరగలి
telugu_huggingface_processed_review_395	పతి కాని పతి,	తిరుపతి, పరపతి
telugu_huggingface_processed_review_396	మేసేది కాసంత మేత: కూసేది కొండంత మోత.	తుపాకి/తూట
telugu_huggingface_processed_review_397	కోపము వచ్చినప్పుడల్లా చిందులువేస్తాను. నా ఇష్ట ప్రకారము వచ్చి, వెళతాను. నా పేరు విన్నా, నన్ను చూచినా అందరూ భయపడతారు.	తుఫాన్
telugu_huggingface_processed_review_398	రాజులు నివశించని కోట ఏమిటి?	తులసి కోట
telugu_huggingface_processed_review_399	రెక్కలు ముయ్యని పక్షి - రెప్పలు ముయ్యని జాణ	తూనీగ, చేప
telugu_huggingface_processed_review_400	ఇక్కడ నుండి చూస్తే గుండు, గుండును కొడితే పండు, పండును కొడితే పదహారు వొప్పులు	తెల్ల పాయ
telugu_huggingface_processed_review_401	రోజూ మారేదేది?	తేదీ
telugu_huggingface_processed_review_402	చిటారు కొమ్మన మిఠాయి పొట్లము,	తేనె తుట్టె
telugu_huggingface_processed_review_403	చిన్నపట్నములో చాల గదులు! గదికొక్క సిపాయి! సిపాయికొక్క తుపాకి!,	తేనె పట్టు
telugu_huggingface_processed_review_404	అరచెయ్యంత పట్నంలో అరవై గదులు; గదికొక్క సిపాయి; సిపాయికొక్క తుపాకీ,	తేనె పట్టు
telugu_huggingface_processed_review_405	ఆకాశం లో అరవై గదులు, గదికి ఒక సిపాయి	తేనె పట్టు
telugu_huggingface_processed_review_406	ఆకాశంలో 60 గదులు, గదిగదికోసిపాయి, సిపాయికో తుపాకి?	తేనెపట్టు
telugu_huggingface_processed_review_407	చిటారు కొమ్మన మిఠాయి పొట్లం,	తేనెపట్టు
telugu_huggingface_processed_review_408	వెయ్యి గోవుల మంద, ఒక్కటిగా చేరింది, వేసింది ఒక పెద్ద తియ్యని ముద్ద	తేనెపట్టు
telugu_huggingface_processed_review_409	అడ్డ గోడ మీద పూజారప్ప	తేలు
telugu_huggingface_processed_review_410	ఇంత లేడు మా వీరాస్వామి. వీధికి మోసగాడు. ఏమిటది.,	తేలు
telugu_huggingface_processed_review_411	సద్ద సొప్పలో ఉంటుంది. సుప్పనాతి పేరు?	తేలు
telugu_huggingface_processed_review_412	అడ్డగోడ మీద గిద్ద పూజారప్పు,	తేలు
telugu_huggingface_processed_review_413	గోడమీద బొమ్మ, గొలుసుల బొమ్మ, వచ్చే పోయే వారికి వడ్డించు బొమ్మ?	తేలు
telugu_huggingface_processed_review_414	టెంకాయలో వంకాయ పోతే ఎంత?	తొమ్మిది
telugu_huggingface_processed_review_415	సంతలన్నీ తిరుగుతాడు. సమానంగా పంచుతాడు.	త్రాసు
telugu_huggingface_processed_review_416	సంతలో షావుకారు, ఊరిలో ఉద్యోగరాయుడు, గట్టుమీద గంగారాయుడు!	త్రాసు, కలము, కొంగ
telugu_huggingface_processed_review_417	నూరు పళ్లు, ఒకటే పెదవి.	దానిమ్మ
telugu_huggingface_processed_review_418	లక్కబుడ్డి నిండా లక్షల వరహాలు తినేవారే గాని,దాచి పెట్టుకొనేవారు లేరు.	దానిమ్మ కాయ
telugu_huggingface_processed_review_419	డబ్బా నిండ ముత్యాలు. ఏమిటది?	దానిమ్మ కాయ.
telugu_huggingface_processed_review_420	నూరు పళ్లు, ఒకటే పెదవి	దానిమ్మ పండు
telugu_huggingface_processed_review_421	పచ్చని గుడిలో ఎర్రని రత్నాలు?	దానిమ్మ పండు
telugu_huggingface_processed_review_422	గుడి నిండా కెంపులు! గుడికి తాళము!,	దానిమ్మపండు
telugu_huggingface_processed_review_423	లక్కపిడతలో, లక్ష వరహాలు!	దానిమ్మపండు
telugu_huggingface_processed_review_424	బంగారు భరిణలో రత్నాలు: పగుల గొడితేగాని రావు.	దానిమ్మపండు.
telugu_huggingface_processed_review_425	పొడవాటి మానుకి నీడే లేదు.,	దారి
telugu_huggingface_processed_review_426	కాశీ నుండి కలకత్తా వరకు కదలకుండాపోయేది?	దారి
telugu_huggingface_processed_review_427	నా మీద తల లేనప్పుడే నేను చాలా ఎత్తులో ఉంటాను ఎవరు నేను?	దిండు
telugu_huggingface_processed_review_428	మతి కాని మతి,	దిగుమతి, శ్రీమతి
telugu_huggingface_processed_review_429	ఇల్లంతా వెలుగు, బల్లకింద చీకటి.	దీపం
telugu_huggingface_processed_review_430	తలపుల సందున మెరుపుల గిన్నె.,	దీపం
telugu_huggingface_processed_review_431	దాస్తే పిడికిలో దాగుతుంది. తీస్తే ఇల్లంతా పాకుతుంది.,	దీపం
telugu_huggingface_processed_review_432	ఇంటికి కన్ను కంటికి కన్ను మింటికి కన్ను ఇల్లంతా వెలుగు నిచ్చు.,	దీపం
telugu_huggingface_processed_review_433	దినమంతా నిద్రపోతుంది రాత్రంతా మేలుకుంటుంది?	దీపం
telugu_huggingface_processed_review_434	పళ్ళెంలో పక్షి - ముక్కుకు ముత్యం, తోకతో నీరు - త్రాగుతుంది మెల్లగా	దీపం
telugu_huggingface_processed_review_435	దాస్తే పిడికిలిలో దాగుతుంది, తీస్తే ఇల్లంతా పాకుతుంది	దీపం వెలుగు
telugu_huggingface_processed_review_436	ఆకులేని అడవిలో జీవంలేని జంతువు జీవమున్న జంతువులను వేటాడుతుంది.,	దువ్వెన
telugu_huggingface_processed_review_437	ఆకు మర్రిఆకు - కాయ మామిడికాయ పువ్వు మల్లె నవ్వు? ఆకులేని అడవిలో జీవంలేని జంతువు జీవమున్న జంతువులను వేటాడుతుంది?	దువ్వెన
telugu_huggingface_processed_review_438	జీవం లేని జంతువు ఆకుల్లేని అడవిలో వేటాడబోయింది?	దువ్వెన
telugu_huggingface_processed_review_439	చాలా పళ్ళు ఉన్న కొరక లేనిది ఏమిటి?	దువ్వెన
telugu_huggingface_processed_review_440	పేడ కాని పేడ,	దూద్ పేడ
telugu_huggingface_processed_review_441	పిడికెడంత పిట్ట! అరిచి గోల చేస్తుంది. ఎత్తుకుంటే చెవిలో గుసగుసలు చెబుతుంది.	దూరవాణి
telugu_huggingface_processed_review_442	డాక్టరొచ్చారు సూది వేశారు, కాసులిస్తేను పారిపోయారు.	దోమ
telugu_huggingface_processed_review_443	ఆడలేని బ్యాట్ ఏమిటి?	దోమల బ్యాట్
telugu_huggingface_processed_review_444	సార సారల చెంబు, చక్కని చెంబు ముంచితే మునగదు ముత్యాల చెంబు?	దోసకాయ
telugu_huggingface_processed_review_445	చక్కచక్కని చెంబు, చారల్ల చెంబు, ముంచితే మునగని ముత్యాల చెంబు	దోసకాయ
telugu_huggingface_processed_review_446	యర్రని రాజ్యం, నల్లని సింహాసనం,ఒక రాజు ఎక్కితే ఒకరాజు దిగుతాడు	దోసెలు
telugu_huggingface_processed_review_447	అంకెల్లో లేని పది?	ద్రౌపది.
telugu_huggingface_processed_review_448	పది కాని పది,	ద్రౌపలి
telugu_huggingface_processed_review_449	రాజా వారి తోటలో రోజా పూలు! చూచే వారే గాని, కోసే వారు లేరు. ఏమిటవి?	నక్షత్రములు
telugu_huggingface_processed_review_450	అందరాని వస్త్రంపై అన్నీ వడియాలు,	నక్షత్రాలు
telugu_huggingface_processed_review_451	ఆకాశంలో చెట్టు - చెట్టు నిండా పువ్వులు ఎంత కొట్టినా రాలవు,	నక్షత్రాలు
telugu_huggingface_processed_review_452	కొమ్ములుంటాయి కానీ ఎద్దు కాదు. అంబారీ ఉంటుంది కానీ ఏనుగు కాదు?	నత్త
telugu_huggingface_processed_review_453	మొఖం ఉన్నా మెడ లేనిది?	నది
telugu_huggingface_processed_review_454	సముద్రంలో మునుగునది కానీ, చేపకాదు ఏమిటది?	నది
telugu_huggingface_processed_review_455	కొండల్లో పుట్టి కోనల్లో నడిచి, సముద్రంలో చేరే నెరజాణ	నది
telugu_huggingface_processed_review_456	ఈ కొండకు ఆ కొండకు ఇనుపగొలుసు?	నల్లచీమల బారు
telugu_huggingface_processed_review_457	కన్నుంది చూడలేదు, కాలుంది నడవలేదు?	నవారు మంచం
telugu_huggingface_processed_review_458	‘వారు’ గాని వారు! ఏమి వారు?	నవారు, అయ్యవారు
telugu_huggingface_processed_review_459	ఆకులేని చెట్టు అరవై ఆరు కాయలు కాస్తుంది.	నాగమల్లి
telugu_huggingface_processed_review_460	మా ఇంటి వెనుక ఒక గూనొడు?	నాగలి
telugu_huggingface_processed_review_461	మూడు శిరములున్ను ముదమొప్ప పది కాళ్ళు - కల్గు తోకలు రెండు కన్ను లారు, చెలగి కొమ్ములు నాల్గు చెతులు రెండయా - దీని భావమేమి తిరుమలేశ !	నాగలిదున్నే రైతు
telugu_huggingface_processed_review_462	ఆ ఆటకత్తె ఎప్పుడూలోనే నాట్యం చేస్తుంది	నాలుక
telugu_huggingface_processed_review_463	ఆ ఆట పత్తి ఎప్పుడూ లోనే నాట్యం చేస్తుంది?	నాలుక
telugu_huggingface_processed_review_464	క్రింద గట్టు, పైన గట్టు, మధ్యలో ఎర్ర బొట్టు!	నాలుక
telugu_huggingface_processed_review_465	డొంకలో ఇంపైన మెలికల పాము.	నాలుక
telugu_huggingface_processed_review_466	నిద్రపోయినా కళ్ళు మూయనిది?	నాలుక
telugu_huggingface_processed_review_467	పై నో పలక క్రిందో పలక పలకల మధ్య మెలికల పాము, పామును పట్టా పగ్గలం లేదు పెగ్గెలు పలికే సిగ్గొదినా	నాలుక
telugu_huggingface_processed_review_468	కిందొక పలక, పైనొక పలక, పలకల నడుమ, మెలికల పాము	నాలుక
telugu_huggingface_processed_review_469	ఎగువో పలకా దిగువో పలకా, పలకలకింద మెలికల పామూ, పామును పట్టా పగ్గం లేదు, పగ్గెలు పలికే సిగ్గొదినా	నాలుక
telugu_huggingface_processed_review_470	నూతిలో పాము, నూరు వరహాలిచ్చినా బయటకు రాదు,	నాలుక
telugu_huggingface_processed_review_471	కనిపించని గ్రహం ఏమిటి?	నిగ్రహం.
telugu_huggingface_processed_review_472	మనిషికి రెండే కాళ్లు, ఏడు చేతులు.	నిచ్చెన
telugu_huggingface_processed_review_473	అందరినీ పైకి తీసుకువెళ్లాను. నేను మాత్రం పైకి వెళ్లలేను. నేనెవరు?	నిచ్చెన
telugu_huggingface_processed_review_474	దానము గాని దానము! ఏమి దానము?	నిదానము, మైదానము
telugu_huggingface_processed_review_475	ఏ ప్రశ్నకి నువ్వు ఎప్పుడూ అవును అని సమాధానం చెప్పలేవు?	నిద్రపోతున్నావా?
telugu_huggingface_processed_review_476	ఎర్రటి పండు మీద ఈగైనా వాలదు.,	నిప్పు
telugu_huggingface_processed_review_477	ఈగ ముసరని పండు?	నిప్పు
telugu_huggingface_processed_review_478	నేను ఎప్పుడూ ఆకలిగా ఉంటాను నేను ఎప్పుడూ చనిపోను ఎవరు నన్ను తాకుతారో వారిని ఎర్రగా చేస్తాను, నేను?	నిప్పు
telugu_huggingface_processed_review_479	నేను ప్రతిక్షణం నీతోనే ఉంటాను నీలాగే ఉంటాను కానీ నువ్వు నన్ను తాకలేవు,ఎవరు నేను?	నీ నీడ
telugu_huggingface_processed_review_480	ఇది నీకు సంబంధించినది దీనిని ఇతరులకు నీకన్నా ఎక్కువగా ఉపయోగిస్తారు ఏమిటది?	నీ పేరు
telugu_huggingface_processed_review_481	గాలిలో ఎగిరే అద్దము! చేతిలో పడితే పగిలి పొతుంది.,	నీటి బుడగ
telugu_huggingface_processed_review_482	నిలబడితే నిలుస్తుంది, కూర్చుంటే కూలబడుతుంది?	నీడ
telugu_huggingface_processed_review_483	జామ చెట్టు కింద జానమ్మ, ఎంత గుంజినా రాదమ్మా.	నీడ
telugu_huggingface_processed_review_484	వెలుతురులో నీతోటే ఉంటుంది. చీకటిలో తప్పించుకు పోతోంది. ఏమిటదీ.,	నీడ
telugu_huggingface_processed_review_485	మనతో వస్తుంది, మనకు చెప్పకుండానే వెళ్తుంది?	నీడ
telugu_huggingface_processed_review_486	పొంచినదెయ్యం, పోయినచోట ప్రత్యక్షం	నీడ
telugu_huggingface_processed_review_487	తట్టుకు మారుతట్టు, నీ పక్కనున్నదేమిటి	నీడ
telugu_huggingface_processed_review_488	రసం కాని రసం	నీరసం, సరసం, విరసం
telugu_huggingface_processed_review_489	చూడబోతే చిన్న ముండ! విప్పుతుంటే ఎన్ని చీరలైనా వస్తాయి.	నీరు ఉల్లిపాయ
telugu_huggingface_processed_review_490	ఈనె లేని ఆకు?	నీరుల్లి ఆకు
telugu_huggingface_processed_review_491	నువ్వు ఒక వ్యక్తి వెనకాల నుంచొని ఉన్నప్పుడు ఆ వ్యక్తి అదే సమయంలో నీ వెనకాల ఎలా నుంచొని ఉండగలడు?	నువ్వు,ఆ వ్యక్తి ఒకరికొకరు వెనకకు తిరిగి నిలబడ్డారు కనుక
telugu_huggingface_processed_review_492	భరణి కార్తిలో చల్లినకాయకు చిప్పెడు పంట?	నువ్వుల పంట
telugu_huggingface_processed_review_493	చారెడు నీళ్ళల్లో చామంతి బిళ్ళ?	నూనె, నూనె లో వడ
telugu_huggingface_processed_review_494	నాకు కన్నులంటే చాలా ఉన్నాయి. నేను చేసేది మాత్రం రెండితోనే.,	నెమలి
telugu_huggingface_processed_review_495	పాముని చంపుతాను కానీ, గ్రద్దను కాను, ఒళ్లంతా కళ్లు ఉంటాయి, కాని ఇంద్రుడుని కాను, నాట్యం చేస్తాను కానీ శివుడిని కాను, నేనెవర్ని?	నెమలి
telugu_huggingface_processed_review_496	చిన్న ఇంటి నిండా తెల్లటి పండ్లు!	నోటిలోని దంతములు
telugu_huggingface_processed_review_497	ఒక సభ ఆ సభలో 32 మంది సభ్యులు అందులో ఒక నాట్యగత్తె నాట్యం వేస్తూ కనిపిస్తుంది?	నోరు, నోటిలో 32 పళ్ళు, నాలుక.
telugu_huggingface_processed_review_498	తవ్వని కుంట కురవని నీరు?	నోరు, లాలాజలం
telugu_huggingface_processed_review_499	ఎగ్జామినర్ దిద్దని పేపర్ ఏమిటి?	న్యూస్ పేపర్.
telugu_huggingface_processed_review_500	ఐదు తంత్రాలు గలది.పిల్లలకు మహాఇష్టమైనది	పంచతంత్రం
telugu_huggingface_processed_review_501	జాబు గాని జాబు ఏమి జాబు?	పంజాబు
telugu_huggingface_processed_review_502	నడవలేని కాలు ఏమిటి?	పంపకాలు
telugu_huggingface_processed_review_503	గుడ్డు పెట్టలేని కోడి ఏమిటి?	పకోడి
telugu_huggingface_processed_review_504	కోడిగాని కోడి! ఏమి కోడి?	పకోడి, చెగోడి
telugu_huggingface_processed_review_505	దీనిని పైకి తీయడం చాలా సులభం కానీ దూరంగా విసిరి వేయడం చాలా కష్టం?	పక్షి ఈక
telugu_huggingface_processed_review_506	పిఠాపురం చిన్నవాడా, పిట్టలకు వేటగాడా,బతికిన పిట్టను కొట్టా వద్దు, చచ్చిన పిట్టను తేనూ వద్దు, కూరకు లేకుండా రానూ వద్దు	పక్షి గుడ్డు
telugu_huggingface_processed_review_507	అమారా దేశం నుంచి తుమారా పండ్లు తెస్తే కొనే వారే గాని తినేవారు లేరు.,	పగడం
telugu_huggingface_processed_review_508	ఆకాశం పచ్చన నక్షత్రాలు తెల్లన	పచ్చిమిరపకాయలు
telugu_huggingface_processed_review_509	జీవంలేని గుర్రాన్నెక్కి జిగటాకోల చేతబట్టి ఆకుల్లేని అడవిలోకి వేటాడబోయింది టక్కులాడి.,	పడవ
telugu_huggingface_processed_review_510	భూమి చూసి నిలుచును?	పడవ
telugu_huggingface_processed_review_511	పైన చూస్తే పండు, పగుల గొడితే బొచ్చు?	పత్తి కాయ.
telugu_huggingface_processed_review_512	బంగారు చెంబులో, వెండి గచ్చకాయ?	పనస తొన
telugu_huggingface_processed_review_513	ఒళ్లంతా ముళ్ల్లే కానీ రత్నలాంటి బిడ్డలు,	పనస పండు
telugu_huggingface_processed_review_514	తండ్రి గరగర! తల్లి పీచు పీచు! బిడ్డలు రత్నమాణిక్యములు!,	పనస పండు
telugu_huggingface_processed_review_515	ఓహోహో హాలయ్య - వల్లంతా గరుకయ్యా - కరకర కోస్తె కడుపంతా తీపయ్యా!	పనస పండు.
telugu_huggingface_processed_review_516	ఒహొహొ బాలయ్యా ఒళ్ళంతా ముళ్ళయ్య పరపరకోసేస్తే కడుపంతా తీపయ్య.,	పనసకాయ
telugu_huggingface_processed_review_517	తండ్రి గరగర, తల్లి పీచుపీచు, బిడ్డలు రత్నమాణిక్యాలు, మనుమలు బొమ్మరాళ్ళు.	పనసకాయ
telugu_huggingface_processed_review_518	బంగారు చెంబులో వెండి గచ్చకాయ,	పనసతొన.
telugu_huggingface_processed_review_519	పచ్చ పచ్చని తల్లి: పసిడి పిల్లల తల్లి: తల్లిని చీలిస్తే తియ్యని పిల్లలు	పనసపండు
telugu_huggingface_processed_review_520	బంగారు చెంబులో వెండి గచ్చకాయ,	పనసపండు గింజ
telugu_huggingface_processed_review_521	అందంకాని అందం	పరమానందం, బ్రహ్మానందం
telugu_huggingface_processed_review_522	నల్లని పొలంలో తెల్లని విత్తనాలు, చేత్తో చల్లుతారు నోటితో ఏరుతారు?	పలక అందులోని అక్షరాలు
telugu_huggingface_processed_review_523	వంకర టింకర మాను.. కష్ట జీవుల గూడూ, ఈడూ జోడూ అవును	పల్లకీ.
telugu_huggingface_processed_review_524	రసరసాలు తిన్నా, రాజు కడుపులో పేగుల్లేవు	పళ్ళెం
telugu_huggingface_processed_review_525	కనిపించని వనం ఏమిటి?	పవనం.
telugu_huggingface_processed_review_526	ఉదయం నాలుగు కాళ్లతో నడిచేది,మధ్యాన్నం రెండు కాళ్ల తో నడిచేది,సాయంత్రం మూడు కాళ్ళతో నడిచేది.	పసితనం లో నాలుగు కాళ్ళు, పెద్దయ్యాక రెండు కాళ్ళు, వృద్ధా ప్యం లో మూడు కాళ్ళు
telugu_huggingface_processed_review_527	తాగలేని రసం ఏమిటి?	పాదరసం.
telugu_huggingface_processed_review_528	భోజనంలో పనికి రాని రసం ఏమిటి?	పాదరసం.
telugu_huggingface_processed_review_529	పాలు కాని పాలు,	పాపాలు, పీపాలు, కోపాలు, తాపాలు, శాపాలు, మురిపాలు, లోపాలు, దీపాలు
telugu_huggingface_processed_review_530	తాగలేని పాలు ఏమిటి?	పాపాలు.
telugu_huggingface_processed_review_531	చిక్కటి కారడవిలో చక్కని దారి,	పాపిట
telugu_huggingface_processed_review_532	నల్లపడవలో తెల్లటిదారి?	పాపిడి
telugu_huggingface_processed_review_533	నల్లని చేనులో తెల్లని దారి ఏమిటది?	పాపిడి.
telugu_huggingface_processed_review_534	డొంకలో మెలికల కఱ్ఱ?	పాము
telugu_huggingface_processed_review_535	శాస్త్రం చెప్పన్నా.. నేల గీరన్నా..	పార
telugu_huggingface_processed_review_536	శాస్త్రం చెన్నప్ప,నేల గీరప్ప, మూల నక్కప్ప	పార
telugu_huggingface_processed_review_537	మారుతట్టు మల్లయ్య ముడ్డి దేకయ్య	పార
telugu_huggingface_processed_review_538	తిత్తిలో నుండి తీయగలమేమో గాని, పొయ్యలెము	పాలు
telugu_huggingface_processed_review_539	జోడు గుఱ్ఱముల మీద ఒకడే రాజు!	పావు కోళ్ళ
telugu_huggingface_processed_review_540	రాయి గాని రాయి! ఏమి రాయి?	పావురాయి
telugu_huggingface_processed_review_541	ఎర్ర మేడలో పచ్చ దీపాలు, దీపాలు చూదామని మేడ తలుపు తీసిన కళ్ళ వెంబడి నీరుకారు	పిచ్చిమిరప
telugu_huggingface_processed_review_542	అరచేతి కింద అరిసె,	పిడక
telugu_huggingface_processed_review_543	అరుగు గోడకు అరచేయి,	పిడక
telugu_huggingface_processed_review_544	అమ్మ కడుపున పుట్టాను. అంతా సుఖాన ఉన్నాను. నీచే దెబ్బలు తిన్నాను. నిలువున ఎండిపోయాను. నిప్పులు గుండు తొక్కాను. గుప్పెడ బూడిద అయినాను.,	పిడక
telugu_huggingface_processed_review_545	నీచేతి దెబ్బలు తిన్నాను నిలువునా ఎండిపోయాను. నిప్పుల గుండమును తొక్కాను. గుప్పెడు బూడిదనయ్యాను.,	పిడక
telugu_huggingface_processed_review_546	అబ్బాయి గారి దొడ్లో పెద్ద బొప్పాయి పండు పడితే పరుగెత్త లేక పదిమంది చచ్చారు.,	పిడుగు
telugu_huggingface_processed_review_547	నాలో చాలా కీస్ ఉంటాయి కానీ నేను ఒక తాళం కూడా తెరవలేను. ఎవరు నేను?	పియానో
telugu_huggingface_processed_review_548	తనువంతా రంధ్రాలు కానీ తీయగా పాడుతాను?	పిల్లనగ్రోవి
telugu_huggingface_processed_review_549	లక్కబుడ్డి నిండా, లక్ష వరహాలు?	పుచ్చకాయ
telugu_huggingface_processed_review_550	అవ్వ చీరకు పుట్టెడు చిల్లులు.,	పుట్ట
telugu_huggingface_processed_review_551	జల్లు పడగానే, జండా లేస్తుంది.	పుట్ట గొడుగు
telugu_huggingface_processed_review_552	కాళ్ళ క్రింద కోడి కదలకుండా గ్రుడ్లు పెట్టు?	పుట్టగొడుగు
telugu_huggingface_processed_review_553	వేసుకోలేని గొడుగు ఏమిటి?	పుట్టగొడుగు.
telugu_huggingface_processed_review_554	ఆరామడల నుండి అల్లుడొస్తే అత్తగారొడ్డించింది విత్తులేని కూర?	పుట్టగొడుగులు
telugu_huggingface_processed_review_555	తెల్లటి శనగలలో ఒకటే రాయి. చేతితో చల్లడం. నోటితో ఏరడం.,	పుస్తకం
telugu_huggingface_processed_review_556	తెల్లటి పొలంలో నల్లటి విత్తనాలు. చేతితో చల్లడం, నోటితో ఏరుకోవడం.	పుస్తకం
telugu_huggingface_processed_review_557	నాలో చాలా మాటలు ఉంటాయి కానీ నేను మాట్లాడలేను,ఏమిటి?	పుస్తకం
telugu_huggingface_processed_review_558	నేనెన్నో మంచి విషయములను నేర్పుతాను గానీ, నాకు మాటలు రావు. నేను మీకు ప్రపంచమును చూపగలను గానీ, నేను చూడలేను. మరి నేనెవరిని?	పుస్తకము
telugu_huggingface_processed_review_559	అందరూ నమస్కరించే కాలు ఏమిటి?	పుస్తకాలు
telugu_huggingface_processed_review_560	బంతి కాని బంతి,	పూబంతి
telugu_huggingface_processed_review_561	కట్టుకుని, పెట్టుకునేది?	పూల దండ
telugu_huggingface_processed_review_562	వంకర టింకర మ్రాను! కష్ట జీవుల గూడే ఈడు, జోడు! విప్పితే, ఇంకో ఇల్లుంది. ఏమిటది?	పెండ్లి పల్లకి
telugu_huggingface_processed_review_563	అయ్యకు అందవు. అమ్మకు అందుతాయి.	పెదవులు
telugu_huggingface_processed_review_564	అమ్మంటే దగ్గరకు.. అయ్యంటే దూరంగా పోయేవి ఏమిటి?	పెదవులు
telugu_huggingface_processed_review_565	అమ్మంటే దగ్గరకు అయ్యంటే దూరంగా పోవును?	పెదవులు
telugu_huggingface_processed_review_566	అమ్మ అంటే అందుతాయి నాన్న అంటే అందవు?	పెదవులు
telugu_huggingface_processed_review_567	అయ్యంటే దూరంగా వెళ్లి అమ్మంటే దగ్గరకు వచ్చేవి ఏమిటి?	పెదవులు
telugu_huggingface_processed_review_568	అన్నకందవు అమ్మ కందుతాయి.,	పెదవులు
telugu_huggingface_processed_review_569	అమ్మ అంటే కలుస్తాయి, నాన్న అంటే కలవవు	పెదవులు
telugu_huggingface_processed_review_570	అయ్య అంటే కలవవు, అమ్మ అంటే కలుస్తాయి	పెదవులు
telugu_huggingface_processed_review_571	అక్క ఇంటిలో చెల్లి ఇంటిలోనికి వెలుగు తెస్తుంది?	పెద్ద పొయ్యి
telugu_huggingface_processed_review_572	మొదటి ర్యాంకు రావాలంటే పరీక్షలు ఎలా రాయాలి?	పెన్నుతో
telugu_huggingface_processed_review_573	నడుస్తూ నడుస్తూ ఆగిపోతుంది. దాని పీక మీదకు కత్తిని తెస్తేగానీ నడువదు. ఏమిటది?	పెన్సిల్
telugu_huggingface_processed_review_574	బుడబుక్కలోడొచ్చి భూమంతా చాటించె! మధ్యాహ్నామునకేమో మాయమాయే!,	పేడ నీరు
telugu_huggingface_processed_review_575	చెట్టు కొడితే పిట్ట లేచి పోయె!,	పేడు
telugu_huggingface_processed_review_576	గరికపోచలపై గాడిదలు నాట్యమాడు?	పేను
telugu_huggingface_processed_review_577	ఐదుగురు, ఐదుగురు, దొంగలు రెండు జట్లు గా పోయి ఒక జీవాన్ని తెచ్చారు.వెంటనే చంపారు.	పేను
telugu_huggingface_processed_review_578	అంబులో పుట్టింది, జంబులో పెరిగింది, అరచెయ్యికొచ్చింది, అంతరించిపోయింది	పేను
telugu_huggingface_processed_review_579	ఓహొయి రాజా! ఒడ్డు పొడుగేమి? పట్టుకోబోతే పిడికెడు లేవు?	పొగ
telugu_huggingface_processed_review_580	ఇంటి వెనుక ఇంగువ చెట్టు ఎంత కోసినా తరగదు,	పొగ
telugu_huggingface_processed_review_581	ఏటి నీటిన వెంపలి చెట్టు ఎంత కోసినా గుప్పెడు కాదు.	పొగ
telugu_huggingface_processed_review_582	ఇంటి వెనక ఇంగువ చెట్టు, ఎంత కోసినా గుప్పెడు కాదు	పొగ
telugu_huggingface_processed_review_583	చారల పాము, చక్కటి పాము, నూతిలో పాము, నున్ననైనా పాము.	పొట్లకాయ
telugu_huggingface_processed_review_584	ఆకాశంలో పాములు?	పొట్లకాయ
telugu_huggingface_processed_review_585	చారల చారల పాము, చక్క చక్కని పాము, నూతిలోని పాము, నున్ననైన పాము	పొట్లకాయ
telugu_huggingface_processed_review_586	పోకంత పొట్టి బావ, కాగంత కడప మోస్తాడు.	పొయ్యి
telugu_huggingface_processed_review_587	ముక్కులేని పిట్ట ముళ్ళన్నీ ఏరుకు తిన్నది.	పొయ్యి
telugu_huggingface_processed_review_588	అక్క ఇట్ల కూడాని చెల్లె ఇంట్లోకు పోతది?	పొయ్యి మీద కుండ
telugu_huggingface_processed_review_589	చక్కని రాజుకు ఒళ్లంతా బొచ్చు?	పొలం గట్టు
telugu_huggingface_processed_review_590	వంరి వంకల రాజు, వళ్ళంతా బొచ్చు	పొలం గట్టు
telugu_huggingface_processed_review_591	తాపం గాని తాపం	ప్రతాపం
telugu_huggingface_processed_review_592	హంస ముక్కుకి ముత్యం కట్టుకొని తోకతో నీళ్లు తాగుతుంది?	ప్రమిద
telugu_huggingface_processed_review_593	కుమ్మరి కుప్పయ్య, పత్తి పాపయ్య,ఆముదాల అప్పయ్య అంతా ఏకమైనారు?	ప్రమిద
telugu_huggingface_processed_review_594	హంస ముక్కుకి, ముత్యం కట్టుకొని తోకతో నీళ్ళు త్రాగుతుంది?	ప్రమిద
telugu_huggingface_processed_review_595	వెలిగించలేని క్యాండిల్?	ఫిల్డర్ క్యాండిల్.
telugu_huggingface_processed_review_596	వేలికి పెట్టుకోలేని రింగ్ ఏమిటి?	ఫైరింగ్
telugu_huggingface_processed_review_597	భయపెట్టే రింగ్?	ఫైరింగ్
telugu_huggingface_processed_review_598	దీనికి చాలా కళ్లుంటాయి గాని ఇది చూడలేదు,ఏమిటది?	బంగాళదుంప
telugu_huggingface_processed_review_599	కదలనిది ఏందిరా? కదిలేది ఏందిరా? నలిగేది ఏందిరా?	బండ, గుండు, గింజ
telugu_huggingface_processed_review_600	పచ్చపచ్చనిది అదే, పసుప్పూసుకునేది అదే, దేశం తిరిగేది అదే, దేవుని పక్కన పడుకునేదదే	బంతిపువ్వు
telugu_huggingface_processed_review_601	నల్ల బండ క్రింద నలుగురు దొంగలు,	బర్రె (గేదె, ఎనుము) క్రింది పొదుగులు
telugu_huggingface_processed_review_602	నా చుట్టూ అద్దములు వుంటాయి గానీ, అద్దముల మేడను కాను. వేగముగా పరుగెడుతుంటాను గానీ, జింకను కాను. నాతో అందరికీ పని వుంటుంది గానీ, ప్రభుత్వపు కార్యాలయమును కాను.	బస్
telugu_huggingface_processed_review_603	ప్లాస్టిక్ వాటర్ బాటిల్ బరువు ఒక కిలో దానిని అరకిలో చేయాలి అంటే ఏమి జతపరచాలి?	బాటిల్ కు రంధ్రాలు (నీరు బయటకు వెళ్ళడానికి)
telugu_huggingface_processed_review_604	నేను ప్రతిరోజు గెడ్డం తీస్తాను కానీ నా గడ్డం ఎప్పటికీ అంతే ఉంటుంది ఎవరు నేను?	బార్బర్/ క్షురకుడు
telugu_huggingface_processed_review_605	తొడేవారే గాని, పోసేవారే లేరు.	బావి నీరు
telugu_huggingface_processed_review_606	తళుకు తళుకు నీటిలో శ్రీరాముడు పుట్టె! ఆ శ్రీరాముని కడుపులో ఒక రాముడు పుట్టె! ఆ రాముని కడుపులో వజ్రము పుట్టె!,	బియ్యపు గింజ
telugu_huggingface_processed_review_607	గుప్పెడు పిట్ట.. దాని పొట్టంతా తీపి.	బూరె
telugu_huggingface_processed_review_608	తల కాయ వుంది. తక్కింది లేదు. ఒంటి కాలిపైన గిరగిర తిరిగే ఒయ్యారముల సింగారము!,	బొంగరము
telugu_huggingface_processed_review_609	పొద్దున లేస్తూనే నల్లపిట్ట బావిలో పడింది	బొక్కెన
telugu_huggingface_processed_review_610	అరటిపండుకి పదే విత్తులు,	బొగడగొట్టం
telugu_huggingface_processed_review_611	అడవిలో పుట్టాను, నల్లగామారాను, ఇంటికి వచ్చాను ఎర్రగామారాను, కుప్పలోపడ్డాను తెల్లగామారాను.	బొగ్గు
telugu_huggingface_processed_review_612	అడవిని పుట్టాను, నల్లగ మారాను, ఇంటికి వచ్చాను, ఎర్రగ మారాను, కుప్పలో పడ్డాను, తెల్లగ మారాను	బొగ్గు
telugu_huggingface_processed_review_613	యేరు మీద మిరప చెట్టు నాకగపడుతుంది, నీకగపడదు.	బొట్టు
telugu_huggingface_processed_review_614	తీసుకునే వారి చెయ్యి పైన, ఇచ్చేవారి చెయ్యి క్రింద ఇలా ఎప్పుడుంటుంది?	బొట్టు పెట్టుకునేటప్పుడు
telugu_huggingface_processed_review_615	యమునికైనా భయపడను! కొట్టినా ఏడవను! తిట్టినా బాధ పడను! మీరేమనుకున్న నేనేమనుకోను. మరి నేనెవరిని?	బొమ్మ
telugu_huggingface_processed_review_616	ఇల్లుకాని ఇల్లు?	బొమ్మరిల్లు
telugu_huggingface_processed_review_617	నాకు బ్రాంచ్ లు ఉంటాయి కానీ నాకు పళ్ళు గాని ఆకులు కానీ కాండం కానీ ఉండదు,ఇంతకీ ఎవరు నేను?	బ్యాంక్
telugu_huggingface_processed_review_618	నాకు ప్రాణం లేదు కానీ నేను చచ్చిపోతాను ఎవరిని నేను?	బ్యాటరీ
telugu_huggingface_processed_review_619	హనుమంతుడు అందగాడు?	బ్రహ్మచారి
telugu_huggingface_processed_review_620	చీమలు కనిపెట్టలేని షుగర్ ఏమిటి?	బ్రౌన్ షుగర్
telugu_huggingface_processed_review_621	డబ్బులు ఉండని బ్యాంకు	బ్లడ్ బ్యాంక్
telugu_huggingface_processed_review_622	శుభ్రం చేసేటప్పుడు నల్లగా ఉండి పాడైనప్పుడుతెల్లగా ఉండేది ఏమిటి?	బ్లాక్ బోర్డ్
telugu_huggingface_processed_review_623	ఇది అందరి దగ్గర ఉంటుంది కానీ దాన్ని ఉంచుకోవడానికి ఎవరూ ఇష్టపడరు,ఎవరు నేను?	భయం
telugu_huggingface_processed_review_624	చెట్లు లేని వనం?	భవనం.
telugu_huggingface_processed_review_625	ఎప్పుడూ నీ ముందే ఉంటుంది కానీ నువ్వు దానిని చూడలేవు ఏంటది?	భవిష్యత్తు
telugu_huggingface_processed_review_626	పుట్టేటప్పుడు లేనిది, మధ్యలో వచ్చేది, చివరిదాకా వుండేది!	భార్య
telugu_huggingface_processed_review_627	ఇంటికి లంత ముండ కావాలి?	భీగము
telugu_huggingface_processed_review_628	ఢాం ఢాం పలక! ఢంకా పలకా! ఎంత కొట్టినా… పగులని పలక?	భూమ
telugu_huggingface_processed_review_629	ఈ ప్రపంచంలోని వారందరు నా బిడ్డలే. కాని అమ్మా! అని నన్నెవ్వరూ పిలువరు. ఏమి చేయాలన్నా ఏమి పొందాలన్నా నాలోనే ఎటు పోవాలన్నా ఎక్కడికి వెళ్ళాలన్నా నామీదే.,	భూమి
telugu_huggingface_processed_review_630	తాజ్ మహల్ ఎక్కడుంది?	భూమ్మీద.
telugu_huggingface_processed_review_631	ఉండేది ఒకరి కంఠానికే బంధించడం ఇద్దరిని?	మంగళ సూత్రం
telugu_huggingface_processed_review_632	ఎంతింతాకు బ్రహ్మంతాకు పెద్దలు పెట్టిన పేరంటాకు?	మంగళ సూత్రం
telugu_huggingface_processed_review_633	ఇంతింతాకు బ్రహ్మంతాకు పెద్దలు పెట్టిన పేరంటాకు.	మంగళ సూత్రం
telugu_huggingface_processed_review_634	అడవిలో పుట్టింది. అడవిలో పెరిగింది. మంచి రోజు చూసి పంచ జేరింది.	మంచం
telugu_huggingface_processed_review_635	వేయి కనులు కలిగి, నాలుగు కాళ్లు కలిగి, నరడు పట్టుకొన్న నడవగాజాలడు.	మంచం
telugu_huggingface_processed_review_636	దీనికి ఒక తల నాలుగు కాళ్ళు ఉంటాయి,ఏమిటది?	మంచం
telugu_huggingface_processed_review_637	నాలుగు కాళ్ళ నటారి, తోక లేని తొటారి	మంచం
telugu_huggingface_processed_review_638	బక్క కుక్కకు బండెడు పేగులు,	మంచం
telugu_huggingface_processed_review_639	మాతాత బోడి, మీతాత బోడి పెద్దప్పబోడి, శివలింగంబోడి?	మంచం కోళ్ళు
telugu_huggingface_processed_review_640	నాలుగు కాళ్ళున్నాయి గానీ, జంతువును కాను. నా శరీరమంతా రంధ్రములున్నాయి గానీ, వలను కాను.	మంచము
telugu_huggingface_processed_review_641	దీనిని పట్టుకోగలవు కానీ విసరలేవు, ఏమిటి?	మంచు
telugu_huggingface_processed_review_642	నీడొక్కలో నా కాలు!	మగ్గము
telugu_huggingface_processed_review_643	తండ్రిని చంపి, తాతను గూడి, తండ్రిని కన్నది.	మజ్జిగ
telugu_huggingface_processed_review_644	అడవిలో పుట్టింది, అడవిలో పెరిగింది; మా ఇంటి కొచ్చింది, తైతక్కలాడింది. ఎవరు?	మజ్జిగను చిలికే తెడ్డు. కవ్వము
telugu_huggingface_processed_review_645	తొలుతో చేస్తారు. కర్రతో చేస్తారు. అన్నం పెడతారు, అదే పనిగా బాదుతారు?	మద్దెల
telugu_huggingface_processed_review_646	సినిమాహాలుకి మనతో వస్తుంది. టికెట్ తీసుకుంటుంది. సినిమా చూడదు. మనం చూసి వచ్చేవరకు వేచి చూస్తుంది.	మన వాహనం
telugu_huggingface_processed_review_647	వాయు వేగమును మించి, లోకములన్నీగాలించి, చిటెకెలోఉన్న చోటికి వచ్చు! ఏమిటది?	మనసు
telugu_huggingface_processed_review_648	తొమ్మిది రంధ్రముల బొమ్మ! ఘనమైన తోలు బొమ్మ!,	మనిషి
telugu_huggingface_processed_review_649	యంత్రము గాని యంత్రమును నేను! నాకు అప్పుడపుడు రిపేర్లుంటాయి. ఒక్కసారి ఆగిపోయానంటే, నేను మరలా పనికి రాను. మరి నే నెవరిని?	మనిషి
telugu_huggingface_processed_review_650	లింగడు కన్నెమనసు, దొంగిలించిన దొంగాడు?	మన్మధుడు
telugu_huggingface_processed_review_651	నాకు రెక్కలు లేవు కానీ నేను ఎగరగలను,నాకు కళ్ళు లేవుగాని నేను ఏడవగలను,ఎవరునేను?	మబ్బు
telugu_huggingface_processed_review_652	రణం కాని రణం?	మరణం,తోరణం,ఆభరణం
telugu_huggingface_processed_review_653	ఆకులోడు కాదమ్మా ఆకులుంటాయి, బాలింత కాదమ్మా పాలుంటాయి, సన్యాసోడు కాడమ్మా జడలుంటాయి	మర్రి చెట్టు
telugu_huggingface_processed_review_654	పాలున్న బాలింతను కాదు. జడలు ఉన్నా జటాధారిని కాదు.	మర్రిచెట్టు
telugu_huggingface_processed_review_655	సంధ్య వేళ విచ్చు కుంటుంది.. గుభాళిస్తుంది?	మల్లె పూవ్వు
telugu_huggingface_processed_review_656	గోడలు కిటికీలు లేని రూమ్ ఏది?	మష్రూమ్ (పుట్టగొడుగు)
telugu_huggingface_processed_review_657	ఇంటింటికీ ఒక నల్లోడు	మసిగుడ్డు
telugu_huggingface_processed_review_658	గుంటూరు గుట్ట! ఏలూరు మిట్ట! పదిమంది పట్ట! ఒకడే కట్ట!	మాంగల్యము
telugu_huggingface_processed_review_659	ఇతరులకు ఇచ్చినా కూడా నీ దగ్గర ఉంచుకొనేది ఏమిటి?	మాట
telugu_huggingface_processed_review_660	జీడివారి కోడలు. సిరిగల వారికి ఆడపడుచు వయసులో కులికే వయ్యారి వైశాఖమాసంలో వస్తుంది.,	మామిడి పండు
telugu_huggingface_processed_review_661	ఆకాశం అప్పన్న, నేల దుప్పన్న, ముడ్డి పిసుకన్నా, మూతి నాకన్న	మామిడి పండు
telugu_huggingface_processed_review_662	శివరాత్రికి జీడికాయ, ఉగాదికి ఊరగాయ?	మామిడి పిందె
telugu_huggingface_processed_review_663	అన్నం తినకపోతే ఏమవుతుంది?	మిగిలిపోతుంది.
telugu_huggingface_processed_review_664	ఎక్కలేని మానుకు దిక్కులేని కాఫు,	మిరప చెట్టు
telugu_huggingface_processed_review_665	పచ్చని పందిట్లో ఎర్రని పెళ్ళికూతురు?	మిరప పండు
telugu_huggingface_processed_review_666	వేయలేని టెంట్ ఏమిటి?	మిలిటెంట్
telugu_huggingface_processed_review_667	అంకటి బంకటి కూర, తియ్యగున్నది. ఇంత పెట్టు	మీగడ
telugu_huggingface_processed_review_668	ఆడవాళ్లకుండనిది.. మగవాళ్లకు ఉండేది?	మీసం
telugu_huggingface_processed_review_669	తీస్తే పోతుంది. తెల్లారితే వస్తుంది.,	మీసము
telugu_huggingface_processed_review_670	రోషమునకు మారు పేరు నేను! భీముడను మాత్రము కాను. అందుకే ఎవరికి రోషము వచ్చినా, ముందు నా మీదే చెయ్యి వేస్తారు. నే నెవరిని?	మీసము
telugu_huggingface_processed_review_671	గిలి గాని గిలి! ఏమి గిలి?	ముంగిలి, లోగిలి
telugu_huggingface_processed_review_672	గంపెడు చెట్లలో గుబెలు మన్నాయి?	ముంజు కాయలు
telugu_huggingface_processed_review_673	ఆ ఇంటికి ఈ ఇంటికి మధ్య దూలం,	ముక్కు
telugu_huggingface_processed_review_674	అందమైన గోపురం - మధ్య దూలం - మంచి గాలి లోనికెళ్ళి చెడ్డ గాలి బయటకొచ్చు,	ముక్కు
telugu_huggingface_processed_review_675	వాకిట్లో కలవారి కోడలు పడింది?	ముగ్గు
telugu_huggingface_processed_review_676	ఆకు చిటికెడు. కాయ మూరెడు.,	మునగకాయ
telugu_huggingface_processed_review_677	అడవిలో పుట్టింది. అడవిలో పెరిగింది. వంటినిండా గాయాలు. కడుపునిండా రాగాలు.	మురళి
telugu_huggingface_processed_review_678	వంక వంకల గడ్డి ఎంత కోసిన గుప్పెడు కాదు,	ముళ్ల కంచి
telugu_huggingface_processed_review_679	తోవలో పుట్టేది, తోవలో పెరిగేది, తొవలో పోయేవారి కొంగు పట్టేది?	ముళ్ల మొక్క
telugu_huggingface_processed_review_680	చెట్టు మీద పిట్ట వాలె, పిట్టవాలగా పట్టుకొంటి, పట్టుకొంటే గిచ్చిపెట్టె, గిచ్చిపెడితే విడిచి పెడితి	ముళ్ళ వంకాయ
telugu_huggingface_processed_review_681	పిల్లికి ముందు రెండు పిల్లులు - పిల్లికి వెనుక రెండు పిల్లులు - పిల్లికీ పిల్లికీ మధ్య ఒక పిల్లి, మొత్తం ఎన్ని పిల్లులు?	మూడు
telugu_huggingface_processed_review_682	కిందకి పైకి వెళ్తుంది కానీ కదల లేనిది ఏమిటి?	మెట్లు
telugu_huggingface_processed_review_683	అంగడిలో పెట్టి అమ్మేది కాదు, తక్కెడలో పెట్టి తూచేది కాదు, ఆలోచించటానికి ఆధారమైనది. అది లేకుండా మనిషేకాదు	మెదడు.
telugu_huggingface_processed_review_684	అనంతపురంలో తప్పెట కొడితే అంతకు తగులు ఇంతకు తగులు చెరువులో ఉండే చేపకు తగులు బీళ్ళలో మేసే గొడ్డుకు తగులు బాలింతకు తగులు దీని భావమేమి?	మెరుపు
telugu_huggingface_processed_review_685	కాళ్లు లేవు గానీ నడుస్తుంది. కళ్లు లేవు గానీ ఏడుస్తుంది?	మేఘం
telugu_huggingface_processed_review_686	పైన పటారము! లోన లొటారము!,	మేడిపండు
telugu_huggingface_processed_review_687	అనగనగనగా ఓ అప్సరస. ఆమె పేరులో మధ్య అక్షరం తీసేస్తే మేక.	మేనక
telugu_huggingface_processed_review_688	తన్ను తానే మింగి, మావమౌతుంది.	మైనపు వత్తి
telugu_huggingface_processed_review_689	చింపిరి చింపిరి గుడ్డలు! ముత్యముల వంటి బిడ్డలు!,	మొక్కజొన్న
telugu_huggingface_processed_review_690	చక్కని రాజుకు ఒళ్లంతా ముత్యాలు?	మొక్కజొన్న కంకి
telugu_huggingface_processed_review_691	చింపిరి చింపిరి గుడ్డలు, కానీ ముత్యాలవంటి బిడ్డలు	మొక్కజొన్నపొత్తి
telugu_huggingface_processed_review_692	అత్తకు పన్నీరు. గురుగురుడు, దాని దగ్గరకు వెళ్లితే లబలబలు.	మొగలి చెట్టు
telugu_huggingface_processed_review_693	సువాసన ఉన్నా, పూజకు పనికి రానిది.	మొగలి పూవు
telugu_huggingface_processed_review_694	ఇటుకతో ఇల్లు కట్టి.. దంతాన తనుపుపెట్టే.. తానుబోయి సరసమాడెను,	మొగలిపువ్వు
telugu_huggingface_processed_review_695	ఆకు బారెడు. తోక మూరెడు.	మొగలిపువ్వు
telugu_huggingface_processed_review_696	ఇటుకతో యిల్లు కట్టి.. దంతాన తనునుపెట్టి.. తాను బోయి (రాజు) సరసమాడెను?	మొగలిపువ్వు
telugu_huggingface_processed_review_697	పచ్చన్ని పొదలోన విచ్చుకోనుంది: తెచ్చుకోబోతేను గుచ్చుకుంటుంది. ఏమిటది?	మొగలిపువ్వు
telugu_huggingface_processed_review_698	పూజకు పనికిరాని పువ్వు. పడతులు మెచ్చే పువ్వు.,	మొగలిపువ్వు.
telugu_huggingface_processed_review_699	పచ్చిని పెట్టెలో విచ్చుకోనుంది. తెచ్చుకోపోతేనూ గుచ్చుకుంటుంది.,	మొగిలి పువ్వు
telugu_huggingface_processed_review_700	కాయ గాని కాయ! ఏమి కాయ?	మొట్టికాయ, కజ్జికాయ
telugu_huggingface_processed_review_701	తామరకమలం మీద కలువ పువ్వులు, కలువ పువ్వుల కింద సంపెంగ పువ్వు, సంపెంగపువ్వు కింద దొండపళ్ళు, దొండపళ్ళలో మల్లెమొగ్గలు	మొహము, కళ్ళు, ముక్కు, పెదవులు, పళ్ళు
telugu_huggingface_processed_review_702	ట్రిక్కులు చేసే టక్కుల మారి! చెప్పకుండా పోతాడు. గల్లంతు ఔతాడు.,	మోసగాడు
telugu_huggingface_processed_review_703	ఆయుధంలేని పోరాటమేమిటి?	మౌనపోరాటం.
telugu_huggingface_processed_review_704	నాలో నీరు లేని నదులు ఉంటాయి, రాళ్లు లేని కొండలు ఉంటాయి,భవనాలు లేని ఊరులు ఉంటాయి,ఎవరు నేను?	మ్యాప్
telugu_huggingface_processed_review_705	పళ్ళు ఉన్నా నోరు లేనిది?	రంపం
telugu_huggingface_processed_review_706	నున్నగా చెక్కింది. నూనె మెరుగు పెట్టింది. ఏడాదికి ఒకసారి గంటి కదిలిస్తారు. ఏమిటదీ.,	రథం
telugu_huggingface_processed_review_707	ఎప్పటికీ పాడలేని బ్యాండ్ ఏది?	రబ్బర్ బ్యాండ్
telugu_huggingface_processed_review_708	రవి తల్లిదండ్రులకు ముగ్గురు పిల్లలు ఉన్నారు వారిలో ఒకరు గోపి ఒకరు రాజు మూడవ వారు ఎవరు?	రవి
telugu_huggingface_processed_review_709	నీ దగ్గర ఉన్నదాన్ని యితరులకు పంచినవెంటనే,అది నీదగ్గర ఉండదు ఏంటది?	రహస్యం
telugu_huggingface_processed_review_710	సందు మా బర్రె కొమ్మలాడిచ్చే?	రాగోల
telugu_huggingface_processed_review_711	ఎనిమిది చేతుల ఏబ్రాసీ ఎప్పుడు తిరిగే సోబ్రాసి వెన్నున జంజె వ్రెళ్ళాడు తీసిన కొద్ది తెర్లాడు.,	రాట్నం
telugu_huggingface_processed_review_712	బండి ఎక్కడు, గుఱ్ఱము ఎక్కడు, నడువలేని బాలుడు, ఇంటి ముందర అటు ఇటు తిరుగుతాడు.	రాట్నము
telugu_huggingface_processed_review_713	బడి గాని బడి! ఏమిబడి?	రాబడి, దిగుబడి
telugu_huggingface_processed_review_714	అందరికి నచ్చే బడి ఏమిటి?	రాబడి.
telugu_huggingface_processed_review_715	వానా లేక ఎండా లేక పైరు పచ్చంగా, ఆకు లేక సున్నం లేక నోరు ఎర్రంగ	రామచిలుక.
telugu_huggingface_processed_review_716	స్కూల్ బ్యాగులో ఉండని స్కేలు	రిక్టర్ స్కేలు
telugu_huggingface_processed_review_717	వాహనాలకు ఉండని టైర్ ఏమిటి?	రిటైర్
telugu_huggingface_processed_review_718	ఎండకు ఎండదు వానకు తడవదు అది లేకపోతే జరగదు	రూపాయి బిళ్ళ
telugu_huggingface_processed_review_719	బిళ్ళ కాని బిళ్ళ, లోకం కోరే బిళ్ళ?	రూపాయిబిళ్ళ, తపాళబిళ్ళ
telugu_huggingface_processed_review_720	ఏది అధిక బరువు కలిగి ఉంటుంది ఒక టన్ను దూదా లేక ఒక టన్ను ఇటుకలా?	రెండూనూ
telugu_huggingface_processed_review_721	నువ్వు పరుగు పందెం లో ఉన్నప్పుడు నువ్వు సెకండ్ ప్లేస్ లో ఉన్న వ్యక్తి కి దగ్గరగా ఉంటే నువ్వు ఎన్నో స్థానంలో ఉన్నట్టు?	రెండవస్థానంలో
telugu_huggingface_processed_review_722	మిరపకాయ కొరితే ఏమవుతుంది?	రెండు ముక్కలవుతుంది.
telugu_huggingface_processed_review_723	తల్లి దయ్యం, పిల్ల పగడం.	రేగుపండు
telugu_huggingface_processed_review_724	మాట్లాడుతుంది కానీ మనిషి కాదు,	రేడియో
telugu_huggingface_processed_review_725	తల నుండి పొగ చిమ్ముంది, భూతం కాదు. కన్నులెర్రగా ఉండు రాకాసి కాదు. పాకిపోవుచుండు పాము కాదు?	రైలు
telugu_huggingface_processed_review_726	కిటకిట బండి కిటారు బండి. ఎందరు కూర్చున్నా విరగని బండి.,	రైలు
telugu_huggingface_processed_review_727	కన్నులెర్రగా ఉండును రాకాసి కాదు, తల నుండి పొగ చిమ్ముంది, భూతం కాదు, పాకిపోవుచుండు పాము కాదు, ఏమిటది?	రైలు
telugu_huggingface_processed_review_728	కడుపులో పిల్లలు – కంఠములో నిప్పులు, అరుపేమో ఉరుము – ఎరుపంటే భయము – ఎవరది?	రైలు
telugu_huggingface_processed_review_729	రెండు వెన్నెముకలు ఉంటాయి కానీ వేలకొద్దీ ఎముకలు ఉంటాయి,ఎవరు నేను?	రైలు పట్టాలు
telugu_huggingface_processed_review_730	బండ కాని బండ,	రోకలి బండ
telugu_huggingface_processed_review_731	నల్లకుక్కకు నాలుగు చెవులు,	లవంగం
telugu_huggingface_processed_review_732	తినలేని కాయ ఏమిటి?	లెంపకాయ
telugu_huggingface_processed_review_733	ఇక్కడ విడిచిన కోడి ఇందూరు పోయె?	లేఖ
telugu_huggingface_processed_review_734	చాలా కథలు ఉన్న భవనం ఏమిటి?	లైబ్రరీ
telugu_huggingface_processed_review_735	పెట్ట కాని పెట్ట,	లొట్టి పెట్ట
telugu_huggingface_processed_review_736	పలుకుగాని పలుకు : ఎమిటది?	వక్క పలుకు
telugu_huggingface_processed_review_737	నల్లని నాగి, తెల్లని తిమ్మ, పచ్చని పొడి. బావ నోట్టో వసంతం.	వక్క, సున్నం, తమల పాకు.
telugu_huggingface_processed_review_738	ఉడికిందొకటి,ఉడకందొకటి,కాలిందొకటి,కాలందొకటి, ఏమిటది?	వక్క, ఆకు, సున్నం, పొగాకు
telugu_huggingface_processed_review_739	కొట్టకుండా తగిగే దెబ్బ ఏమిటి?	వడదెబ్బ
telugu_huggingface_processed_review_740	పైడిపెట్టెలో ముత్యపు గింజ,	వడ్లగింజ
telugu_huggingface_processed_review_741	ఎప్పుడూ పైకి వెళ్తూనే ఉంటుంది కానీ ఎప్పటికీ కిందకు రానిది ఏంటది?	వయస్సు
telugu_huggingface_processed_review_742	కూర్చోలేని హాలు ఏమిటి?	వరహాలు.
telugu_huggingface_processed_review_743	ఆ రాజు కూతురు అధిక చక్కని దట గోరంత కొప్పు పెట్టి గొలుసులు దిగవేసింది.,	వరివెన్ను
telugu_huggingface_processed_review_744	హస్త ఆరు పాళ్లు, చిత్త మూడు పాళ్లు	వర్షం
telugu_huggingface_processed_review_745	దేహమెల్ల కళ్లు, దేవేంద్రుడు కాదు. నరవాహనము లేక నడిచిపోలేదు. తనకు జీవం లేదు, జీవుల్ని చంపు.	వల
telugu_huggingface_processed_review_746	అందరూ కోరుకునే సతి ఏమిటి?	వసతి.
telugu_huggingface_processed_review_747	పడుతుందేకానీ పైకి లేవలేదు?	వాన
telugu_huggingface_processed_review_748	చన్నులేని ఆవుపాలు, చెయ్యిలేని వాడు పిండె, అగ్నిలేని పాలుకాగె, నోరులేని బాల తాగె	వాన
telugu_huggingface_processed_review_749	నరుడు కాని నరుడు?	వానరుడు
telugu_huggingface_processed_review_750	ఇద్దరు వ్యక్తులు చెస్ ఆడుతూ ఉన్నారు,వారు ఇద్దరూ గెలిచారు ఎలాగా?	వారిద్దరూ వేర్వేరు వ్యక్తులతో ఆడుతున్నారు కనుక
telugu_huggingface_processed_review_751	నిన్న ఏమిటో, నేడు ఏమిటో, రేపు ఏమిటో చెప్పవే చక్కని బొమ్మ! మాసమున కొకసారి మారిపోయే బొమ్మ ఎల్లప్పుడూ గోడ నంటియుండు బొమ్మ!	వాల్ క్యాలెండర్
telugu_huggingface_processed_review_752	ముక్కుతో చూడగలం - కంటితో చూడలేము	వాసన
telugu_huggingface_processed_review_753	ఎంత దానం చేసినా తరగనిది. అంతకంతకూ పెరిగేది.,	విద్య
telugu_huggingface_processed_review_754	ఆకేలేయదు నీరుతాగదు. నేలని పాకదు. ఏమిటి ఆ తీగ?	విద్యత్తు తీగ
telugu_huggingface_processed_review_755	తొడిమ లేని పండు! ఆకు లేని పంట!,	విబూది పండు,ఉప్పు పంట
telugu_huggingface_processed_review_756	సంతలో షావుకారు.. ఊరిలో ఉద్యోగదారు, గట్టుమీద గంగరాయుడు?	విభూతి పండు
telugu_huggingface_processed_review_757	తొడిమ లేని పండు,	విభూది పండు
telugu_huggingface_processed_review_758	ఆకాశంలో ఎగురుతుంది. పక్షి కాదు. మనుషుల్ని ఎగరేసుకుపోతుంది గాలికాదు.	విమానం
telugu_huggingface_processed_review_759	ఆకాశంలో ఎగురుతుంది కానీ పక్షి కాదు,	విమానం
telugu_huggingface_processed_review_760	జీవము లేని గరుడ పక్షి దేశ దేశములూ తిరుగుతుంది.,	విమానము
telugu_huggingface_processed_review_761	ఎంత విసిరినా చేతిలో ఉండే కర్ర	విసనకర్ర
telugu_huggingface_processed_review_762	జింక ఉరకంగా పాలుకారంగా?	విసురు రాయి
telugu_huggingface_processed_review_763	తేరు తిరుగుతుంటే, పూలు రాలతాయి.	విసురు రాయి
telugu_huggingface_processed_review_764	చిటుకు పొటుకులాడి గోడదుంకే లేడి	విస్తరాకు
telugu_huggingface_processed_review_765	కళ్ళు లేకున్నా కనిపించు! నోరు లేకున్నా మాటలాడు! కాళ్ళు లేకున్నా కదలు!,	వీడియో క్యాసెట్
telugu_huggingface_processed_review_766	కాయ మీద మాను, కడు రమ్యమై యుండు, మాను మీద లతలు మలయుచుండు, లతల మీద వ్రేళ్ళు లాస్యమాడుచునుండు, దీని భావమేమి తిరుమలేశ !	వీణ
telugu_huggingface_processed_review_767	గండి చెరువులో గుండు తేలె!,	వెన్న
telugu_huggingface_processed_review_768	దోసెడు నీటిలో దొరసాని జలకాడమాడింది?	వెన్న
telugu_huggingface_processed_review_769	జంటల జంటల కూర, జగన్నాథం కూర, ముంచినా మునగదు, ముత్యాల కూర	వెన్న ముద్ద
telugu_huggingface_processed_review_770	దోసెడు నీళ్ళలో దొరసాని జలకాలాడుతోంది	వెన్న ముద్ద
telugu_huggingface_processed_review_771	కరవలేని పాము?	వెన్నుపాము.
telugu_huggingface_processed_review_772	ఆకాశన అప్పన్న.. నేలకుప్పన్న బోడినాగన్న.. పిండి పిసకన్న,	వెలగపండు
telugu_huggingface_processed_review_773	ఆలు కాని ఆలు	వెలయాలు
telugu_huggingface_processed_review_774	ఇది ఒక గదిని నింపుతుంది కాని ఏమాత్రం చోటు తీసుకోదు,ఏంటది?	వెలుతురు
telugu_huggingface_processed_review_775	ఒక క్షణంలో గదంతా ఎలా నింపగలం?	వెలుతురుతో (కాండిల్ )
telugu_huggingface_processed_review_776	శిత్తిలో ఇద్దరు దొంగలు	వేరు శనక్కాయ, ఆముదం కాయ
telugu_huggingface_processed_review_777	గింజ మునుగుతుంది. కాయ తేలుతుంది.,	వేరు శనగ
telugu_huggingface_processed_review_778	శిత్తిలో ఇద్దరు దొంగలు కూర్చున్నారు,	వేరుశనక్కాయ
telugu_huggingface_processed_review_779	ఒకటే తొట్టి, రెండు పిల్లలు.	వేరుశనగ
telugu_huggingface_processed_review_780	ఒక్కటే కడుపు కానీ రెండు గుడ్లు	వేరుశనగ
telugu_huggingface_processed_review_781	తెలిసేటట్లు పూస్తుంది - తెలియకుండ కాస్తుంది	వేరుశెనగ
telugu_huggingface_processed_review_782	వేసింది ఏమిరా - తీసింది ఏమిరా, వేలుపెట్టి వాసన చూసింది ఏమిరా,	వేసింది సానరా - తీసింది చెక్కరా, వేలుపెట్టి వాసన చూసింది గంధం రా
telugu_huggingface_processed_review_783	వేసిన దేమిరా? వ్రేలు పెట్టి చూసిన దేమిరా?	వేసినది చెక్కరా! వ్రేలుపెట్టి వాసన చూచినది శ్రీ గంధమురా
telugu_huggingface_processed_review_784	సముద్రంలో పుట్టి, సముద్రంలో పెరిగి ఊళ్ళోకొచ్చి అరిచేది?	శంఖం
telugu_huggingface_processed_review_785	నన్ను ఎవరు తయారు చేస్తారో నేను వారికి ఉపయోగపడును,నన్ను ఎవరు కొంటారో అతను నన్ను ఉపయోగించడు, నన్ను ఎవరు వాడుతారు అతను నన్ను ఎప్పుడూ చూడలేడు,ఎవరు నేను?	శవ పేటిక
telugu_huggingface_processed_review_786	పాలుగాని పాలు ఏమిపాలు?	శాపాలు, లోపాలు
telugu_huggingface_processed_review_787	మొక్కకు పూయని రోజాలు ఏమిటి?	శిరోజాలు.
telugu_huggingface_processed_review_788	అంక పొంకలు లేనిది.,	శివలింగం
telugu_huggingface_processed_review_789	రంగం కాని రంగం,	శ్రీరంగం, వీరంగం, కురంగం
telugu_huggingface_processed_review_790	కారు గాని కారులో వెళతాను, వారు గాని వారు చేస్తాను?	షికారు, సవారు
telugu_huggingface_processed_review_791	వీసా అడగని దేశమేమిటి?	సందేశం.
telugu_huggingface_processed_review_792	ధరణిలో పన్నెండు మంది భార్యలు నాకు! ఒక్కో భార్యకు నలుగురు కొడుకులు! మూడువందల అరువది ఐదుమంది మనుమలు!	సంవత్సరము= నెలలు, వారములు, రోజులు
telugu_huggingface_processed_review_793	శాఖలు ఉన్నా, ఆకులు లేనిది?	సంస్థ
telugu_huggingface_processed_review_794	చక్కని మానికి చిక్కని గజ్జలు?	సజ్జకంకి
telugu_huggingface_processed_review_795	లోకమంతా చాప వేసి, నిద్ర పోకుండా తిరుగుతూ వుంటాడు.ఎవరతను?	సముద్రము
telugu_huggingface_processed_review_796	బారు కాని బారు,	సాంబారు
telugu_huggingface_processed_review_797	బారుగాని బారు! ఏమి బారు?	సాంబారు
telugu_huggingface_processed_review_798	మూడుకాళ్ళ ముద్దప్ప, ముందరేసి రుద్దప్పా	సానరాయి
telugu_huggingface_processed_review_799	యంత్రం కాని యంత్రం,	సాయంత్రం
telugu_huggingface_processed_review_800	యంత్రం కాని యంత్రం-కాదిది మంత్రం,	సాయంత్రం
telugu_huggingface_processed_review_801	పచ్చని పందిరిలో, తెల్లని మిద్దె లోపల ఉన్నాడు నల్లని రాజు.	సీతా ఫలపు గింజ
telugu_huggingface_processed_review_802	చిత్రమైన చీరకట్టి - షికారుకెళ్ళె చిన్నది - పూసిన వారింటికే గాని - కాసిన వారింటికి పోదు	సీతాకోక చిలుక
telugu_huggingface_processed_review_803	ఆకు పచ్చ హాస్పటల్, తెల్ల కాంపౌండరు నల్ల డాక్టరు నా పేరేమి?	సీతాఫలం
telugu_huggingface_processed_review_804	చొట్టల చొట్టల కుండ - బోనాలకుండ - సీతమ్మ పేరు చెప్పి మెల్లంగా దించుకో,	సీతాఫలం
telugu_huggingface_processed_review_805	మాతాత ఏటి అవతలికి వెళ్ళి మూడెడ్లను తెచ్చాడు. ఒకటి కరిగేది, ఒకటి తేలేది, ఒకటి మునిగేది.	సున్నము, ఆకు, వక్క
telugu_huggingface_processed_review_806	సన్నని స్తంభం, ఎక్కలేరు దిగలేరు.	సూది
telugu_huggingface_processed_review_807	వేలెడంత పిల్లోడు చీరంతా తిరిగాడు?	సూది
telugu_huggingface_processed_review_808	కన్ను ఉన్నా తల లేనిది?	సూది
telugu_huggingface_processed_review_809	దీనికి ఒకటే కన్ను ఉంటుంది కానీ ఇది చూడలేదు,ఏమిటది?	సూది
telugu_huggingface_processed_review_810	అక్కడిక్కడబండి, అంతరాలబండి మద్దూరి సంతలో మాయమైన బండి.	సూర్యుడు
telugu_huggingface_processed_review_811	ఎప్పుడు ఒంటరిగా తిరుగుతాడు అందరికీ వెలుగునిస్తాడు.	సూర్యుడు
telugu_huggingface_processed_review_812	దేశదేశాలకు ఇద్దరే రాజులు,	సూర్యుడు, చంద్రుడు
telugu_huggingface_processed_review_813	ఎర్రవాడొస్తే, నల్లవాడు పారిపోతాడు	సూర్యుడు, చంద్రుడు.
telugu_huggingface_processed_review_814	ఎర్రవాడొస్తే, నల్లవాడు పారిపోతాడు	సూర్యుడు, చీకటి
telugu_huggingface_processed_review_815	అక్కడిక్కడి బండి అంతరాల బండి: మద్దూరి సంతలోన మాయమైన బండి. ఏమిటది?	సూర్యుడు.
telugu_huggingface_processed_review_816	వాహనాలకు ఉండని టైర్లు ఏమిటి?	సెటైర్లు
telugu_huggingface_processed_review_817	ఇంతింత బండి - ఇనప కట్ల బండి, తొక్కితే నా బండి - తొంభై ఆమడలు పోతుంది.	సైకిలు
telugu_huggingface_processed_review_818	గాలికి తిరిగే గడుసరి, ఊరికే తిరిగే సొగసరి?	సోమరి
telugu_huggingface_processed_review_819	తను మూల కూర్చుని ప్రపంచాన్నే చుట్టి వచ్చేది ఏమిటి?	స్టాంప్
telugu_huggingface_processed_review_820	భీముడు బిగతన్నె, అర్జునుడు అగపట్టె?	స్తంబం, దూలం
telugu_huggingface_processed_review_821	చిలుకని గాని చిలుకను నేను! నేను వస్తున్నా, వెళుతున్నా… అదుగో చిలుక! ఇదుగో చిలుక! అంటారు. చిలక గాని చిలక నైన నేనెవరిని?	స్త్రీ
telugu_huggingface_processed_review_822	నా శరీరమంతా రంధ్రాలు ఉంటాయి కానీ నేను నీటిని నింపి ఉంచగలను ఎవరు నేను?	స్పాంజ్
telugu_huggingface_processed_review_823	నా శరీరమంతా రంద్రాలు వున్నా నాలో నీరు దాచుకోగలను,ఎవరు నేను?	స్పాంజ్
telugu_huggingface_processed_review_824	హరీ అనేలోపుగా ఒక్కసారే విచారం పాడుతుంది?	హంసపాదు
telugu_huggingface_processed_review_825	నారి లేని విల్లు ఏమిటి?	హరివిల్లు
telugu_huggingface_processed_review_826	యాదగిరి నా పేరు గుట్ట ను మాత్రం కాను,ఒక ముఖ్యమంత్రి నా మీద ప్రయానించే వాడు కాని కారు ను కాదు.మరినేనెవరిని?	హెలికాప్టర్
telugu_huggingface_processed_review_827	విసిసిపీ నదిలో ఎక్కువ ఏమున్నాయి?	‘సీ’లు
telugupatham_blogspot_1	ఎర్రటి పండు మీద ఈగైనా వాలదు.	నిప్పు
telugupatham_blogspot_2	ఎందరు ఎక్కిన విరగని మంచం.	అరుగు.
telugupatham_blogspot_3	దాస్తే పిడికిలిలో దాగుతుంది, తీస్తే ఇల్లంతా జారుతుంది.	దీపం వెలుగు.
telugupatham_blogspot_4	తలపుల సందున మెరుపుల గిన్నె.	దీపం
telugupatham_blogspot_5	తెల్లకోటు తొడుక్కున్న ఎర్రముక్కు దొర	కొవ్వొత్తి
telugupatham_blogspot_6	కాళ్ళు చేతులు లేని అందగత్తెకు బోలెడు దుస్తులు.	ఉల్లిపాయ
telugupatham_blogspot_7	నల్లకుక్కకు నాలుగు చెవులు	లవంగం
telugupatham_blogspot_8	తొడిమ లేని పండు, ఆకులేని పంట.	విభూది పండు, ఉప్పు
telugupatham_blogspot_9	దాని పువ్వు పూజకు రాదు. దాని ఆకు దొప్పకు రాదు, దాని పండు అందరు కోరు?	చింతపండు
telugupatham_blogspot_10	తోలు నలుపు, తింటే పులుపు.	చింతపండు
telugupatham_blogspot_11	తొలు తియ్యన, గుండు మింగన్నా?	అరటి పండు
telugupatham_blogspot_12	జానెడు ఇంట్లో, మూరెడు కర్ర?	కుండలో గరిటె.
telugupatham_blogspot_13	పొడవాటి మానుకి నీడే లేదు.	దారి
telugupatham_blogspot_14	ముద్దుగా నుండును, ముక్కుపైకెక్కు, చెవులు రెండూ లాగి చెంప నొక్కు దండి పండితులకు దారి చూపుట వృత్తి.	కళ్లజోడు.
telugupatham_blogspot_15	పైడిపెట్టెలో ముత్యపు గింజ	వడ్లగింజ
telugupatham_blogspot_16	తల్లి కూర్చొండు, పిల్ల పారాడు.	కడవ, చెంబు
telugupatham_blogspot_17	పూజకు పనికిరాని పువ్వు. పడతులు మెచ్చే పువ్వు.	మొగలిపువ్వు.
telugupatham_blogspot_18	అడ్డగోడమీద బుడ్డ చెంబు, తోసినా  ఇటుపక్క పడదు. అటు పక్క పడదు.	ఆబోతు మూపురం.
telugupatham_blogspot_19	మూలన కూర్చుంటుంది. ఎండొచ్చినా, వానొచ్చినా బయటకు బయలుదేరుతుంది.	గొడుగు.
telugupatham_blogspot_20	బంగారు చెంబులో వెండి గచ్చకాయ	పనసతొన.
telugupatham_blogspot_21	పోకంత పొట్టోడు. ఇంటికి గట్టోడు.	తాళం కప్ప
telugupatham_blogspot_22	అమ్మతమ్ముడినికాను, కానీ నేను మీకు మేనమాను.	చందమామ
telugupatham_blogspot_23	అరటిపండుకి పదే విత్తులు	బొగడగొట్టం
telugupatham_blogspot_24	అడవిలో ఆంబోతు రంకే వేస్తుంది	గొడ్డలి
telugupatham_blogspot_25	అరచేతి కింద అరిసె	పిడక
telugupatham_blogspot_26	అలాము కొండకు సలాము కొట్టు	గొడ్డలి
telugupatham_blogspot_27	అంక పొంకలు లేనిది.	శివలింగం
telugupatham_blogspot_28	అడవిలో అక్కమమ తల విలబోసుకుంది?	ఈతచెట్టు
telugupatham_blogspot_29	అక్క ింటిలో చెల్లి ఇంటిలోనికి వెలుగు తెస్తుంది	పెద్ద పొయ్యి
telugupatham_blogspot_30	అరచేతిలో 60 నక్షత్రాలు	జల్లెడ
telugupatham_blogspot_31	అరచేతి పట్నంలో 60 వాకిళ్లు	అద్దం
telugupatham_blogspot_32	అడవిలో పుట్టింది, అడవిలో పెరిగింది. మా ఇంటికి వచ్చింది తైతక్కలాడింది.	కవ్వం
telugupatham_blogspot_33	అవ్వ చీరకు పుట్టెడు చిల్లులు.	పుట్ట
telugupatham_blogspot_34	అరం కణం గదిలో 60 మంది నివాసం	అగ్గిపెట్టె, పుల్లలు
telugupatham_blogspot_35	ఆ బాబా ఈ బాబా పోట్లాడితే కూన రాములు వచ్చి తగువు తీర్చాడు.	తాళం
telugupatham_blogspot_36	ఆకాశంలో 60 గదులు, గదిగదికో సిపాయి, సిపాయికో తుపాకి.	తేనెపట్టు
telugupatham_blogspot_37	ఆకాశంలో అంగవస్ర్తాలు ఆరబెట్టారు.	అరిటాకు
telugupatham_blogspot_38	ఆలుకాని ఆలు.	వెలయాలు
telugupatham_blogspot_39	ఆ కొండకు ఈ కొండకు ఇనుప సంకెళ్లు.	చీమలదండు
telugupatham_blogspot_40	ఆకాశన అప్పన్న.. నేలకుప్పన్న బోడినాగన్న.. పిండి పిసకన్న	వెలగపండు
telugupatham_blogspot_41	ఆకాశాన కొడవళ్లు వ్రేలాడుతున్నాయి.	చింతకాయలు
telugupatham_blogspot_42	ఆకాశాన పటం.. కింద తోక.	గాలిపటం
telugupatham_blogspot_43	ఆకాశంలో పాములు	పొట్లకాయ
telugupatham_blogspot_44	ఓ ఆకు..మర్రి ఆకు.. కాయ.. మామిడి కాయ.. పువ్వు మల్లెపువ్వు	జిల్లేడు
telugupatham_blogspot_45	ఆకులేని అఢవిలో జీవంలేని జంతువు జీవమున్న జంతువులను వేటాడుతుంది.	దువ్వెన
telugupatham_blogspot_46	ఆ ఇంటికి ఈ ఇంటికి లాలా బుడిగి	కుక్కపిల్ల
telugupatham_blogspot_47	ఆ వీధిరాజుకి కొప్పుంది. జుట్టలేదు. కళ్లున్నాయి చూపులేదు	కొబ్బరి కాయ
telugupatham_blogspot_48	ఆరామడల నుంచి అల్లుడు వస్తే అత్తగారు వడ్డించింది విత్తులేని కూర	పుట్టగొడుగులు
telugupatham_blogspot_49	ఇక్కడ విచిన కోడి ఇందూరు పోయింది	లేఖ
telugupatham_blogspot_50	ఇటుకతో ఇల్లు కట్టి.. దంతాన తనుపుపెట్టే.. తానుబోయి సరసమాడెను	మొగలిపువ్వు
telugupatham_blogspot_51	ఇల్లుకాని ఇల్లు	బొమ్మరిల్లు
telugupatham_blogspot_52	ఇంటికి అందం	గడప
telugupatham_blogspot_53	ఇంటికి అంత ముండ కావాలి	భీగము
telugupatham_blogspot_54	ఇల్లంతాఎలుక బొక్కలు..	జల్లెడ
telugupatham_blogspot_55	ఇల్లంతా తిరిగి మూల కూర్చొంది	చీపురుకట్ట
telugupatham_blogspot_56	ఇంటి వెనుక ఇంగువ చెట్టు ఎంత కోసినా తరగదు	పొగ
telugupatham_blogspot_57	ఇంతింతాకు, బ్రహ్మంతాకు, విరిస్తే ఫెళఫెళ	అప్పడం
telugupatham_blogspot_58	ఆ ఇంటికి ఈ ఇంటికి మధ్య దూలం	ముక్కు
telugupatham_blogspot_59	ఈత చెట్టుకి ఇద్దరు బిడ్డలు	కల్లు కుండలు
telugupatham_blogspot_60	ఈకలు ఈరమ్మ, ముళ్ల పేరమ్మ, సంతకు వెళితే అందరూ కొనేవారే	ఉల్లిపాయ
telugupatham_blogspot_61	అడవిలో పుట్టింది, మా ఇంటికి వచ్చింది. తాడేసి కట్టింది. తైతక్కలాడింది. కడవలో దూకింది. పెరుగులో మునిగింది. వెన్నంత తెచ్చింది.	కవ్వం
telugupatham_blogspot_62	దాస్తే పిడికిలో దాగుతుంది. తీస్తే ఇల్లంతా పాకుతుంది.	దీపం
telugupatham_blogspot_63	నామముంది కాని పూజారి కాదు. వాలముది కానీ కోతి కాదు.	ఉడుత
telugupatham_blogspot_64	అరచేతిలో అద్దం.. ఆరు నెలల యుద్ధం	గోరింటాకు
telugupatham_blogspot_65	ఆకు చిటికెడు. కాయ మూరెడు.	మునగకాయ
telugupatham_blogspot_66	అమ్మ తమ్ముడిని కాదు. నేను మీ అందరికీ మేనమామనే?	చందమామ
telugupatham_blogspot_67	అడవిలో ఆంబోతు రంకె వేస్తుంది.	ఆకలి
telugupatham_blogspot_68	అనగనగా ఓ అప్సరస. పేరు మధ్యలో అక్షరం తీసేస్తే మేక	మేనక
telugupatham_blogspot_69	నీళ్లలో పుడుతుంది. నీళ్లలో పడితే చస్తుంది.	ఉప్పు
telugupatham_blogspot_70	హస్త ఆరు పాళ్లు, చిత్త మూడు పాళ్లు?	వర్షం
telugupatham_blogspot_71	హనుమంతుడి భార్య గొప్ప ధనవంతురాలు. తట్టెడు సొమ్ములు పెట్టుకొని తల వంచుతుంది.	కొర్రకంకి
telugupatham_blogspot_72	సన్నజాజులు కన్న చక్కని పూలు, సన్న తీగలు జల్లుగా పూయును.	కాకరపూలు
telugupatham_blogspot_73	సంధ్యవేళలో విచ్చుకుంటుంది. గుభాళిస్తుంది	మల్లెపూవు
telugupatham_blogspot_74	శివరాత్రికి శివ శివా అంటూ పోయేది?	చలి
telugupatham_blogspot_75	రంగం కాని రంగం	శ్రీరంగం, వీరంగం, కురంగం
telugupatham_blogspot_76	రాయి కాని రాయి	కిరాయి, తురాయి, షరాయి, కీచురాయి
telugupatham_blogspot_77	రణం కాని రణం	కరణం, శరణం, చరణం
telugupatham_blogspot_78	యంత్రం కాని యంత్రం	సాయంత్రం
telugupatham_blogspot_79	మాను కాని మాను	కమాను
telugupatham_blogspot_80	మత్తు కాని మత్తు	గమ్మత్తు.. కిమ్మత్తు
telugupatham_blogspot_81	మతి కాని మతి	దిగుమతి, శ్రీమతి
telugupatham_blogspot_82	బోది కాని బోది	కబోది
telugupatham_blogspot_83	బారు కాని బారు	సాంబారు
telugupatham_blogspot_84	బాడి కాని బాడీ	కబడి, లంబాడీ
telugupatham_blogspot_85	బండ కాని బండ	రోకలి బండ
telugupatham_blogspot_86	బంతి కాని బంతి	పూబంతి
telugupatham_blogspot_87	బొట్టు కాని బొట్టు	తాళి బొట్టు, పచ్చబొట్టు
telugupatham_blogspot_88	మందు కాని మందు	కామాందు
telugupatham_blogspot_89	పెట్ట కాని పెట్ట	లొట్టి పెట్ట
telugupatham_blogspot_90	పేడ కాని పేడ	దూద్ పేడ
telugupatham_blogspot_91	పురం కానిపురం	కాపురం, గోపురం
telugupatham_blogspot_92	పాలు కాని పాలు	పాపాలు, పీపాలు, కోపాలు, తాపాలు, శాపాలు, మురిపాలు, లోపాలు, దీపాలు
telugupatham_blogspot_93	పాప కాని పాప	కనుపాప
telugupatham_blogspot_94	పది కాని పది	ద్రౌపలి
telugupatham_blogspot_95	పతి కాని పతి	తిరుపతి, పరపతి
telugupatham_blogspot_96	చిటపట చినుకులు చిటారు చినుకులు. ఎంతరాలినా చప్పుడు కావు.	కన్నీళ్లు
telugupatham_blogspot_97	అడవిలో పుట్టింది. అడవిలో పెరిగింది. మా ఇంటికొచ్చింది. తైతక్కలాడింది.	కవ్వం
telugupatham_blogspot_98	కిటకిట బండి కిటారు బండి. ఎందరు కూర్చున్నా విరగని బండి.	రైలు
telugupatham_blogspot_99	రాజుగారి తోటలో రోజాపూజలు. చూసేవారేగాని, లెక్కించేవారు లేరు.	చుక్కలు
telugupatham_blogspot_100	చావిట్లో సద్దు కర్ర.	కలం
telugupatham_blogspot_101	నున్నగా చెక్కింది. నూనె మెరుగు పెట్టింది. ఏడాదికి ఒకసారి గంటి కదిలిస్తారు. ఏమిటదీ.	రథం
telugupatham_blogspot_102	ఇంత లేడు మా వీరాస్వామి. వీధికి మోసగాడు. ఏమిటది.	తేలు
telugupatham_blogspot_103	ఆకాశాన ఎగురుతుంది. పక్షి కాదు. మనషుల్ని ఎగరేసుకుపోతుంది. గాలి కాదు. ఏమిటదీ.	విమానం
telugupatham_blogspot_104	వెలుతురులో నీతోటే ఉంటుంది. చీకటిలో తప్పించుకు పోతోంది. ఏమిటదీ.	నీడ
telugupatham_blogspot_105	తెల్లటి శనగలలో ఒకటే రాయి. చేతితో చల్లడం. నోటితో ఏరడం.	పుస్తకం
telugupatham_blogspot_106	జీడివారి కోడలు. సిరిగల వారికి ఆడపడుచు వయసులో కులికే వయ్యారి వైశాఖమాసంలో వస్తుంది.	మామిడి పండు
telugupatham_blogspot_107	ముక్కు మీద కెక్కు. ముంద చెవులు నొక్కు. టక్కు నొక్కుల సోకు. జారిందంటే పుటుక్కు.	కళ్లజోడు
telugupatham_blogspot_108	అక్కా చెల్లెల అనుబంధం. ఇరుగూ పొరుగూ సంబంధం. దగ్గర, దగ్గర ఉన్నారు. దరికి చేరలేకున్నారు.	కళ్లు.
telugupatham_blogspot_109	ఎంత దానం చేసినా తరగనిది. అంతకంతకూ పెరిగేది.	విద్య
telugupatham_blogspot_110	కుడితి తాగదు. మేత మేయదు. కాని కుండెకు పాలు ఇస్తుంది.	తాడి చెట్టు
telugupatham_blogspot_111	నాగస్వరానికి లొంగని త్రాచు. నిప్పంటిచగానే తాడెత్తు లేస్తుంది.	చిచ్చు బుడ్డి
telugupatham_blogspot_112	నాకు కన్నులంటే చాలా ఉన్నాయి. నేను చేసేది మాత్రం రెండితోనే.	నెమలి
telugupatham_blogspot_113	పాతాల మేడకు పది కూసాలు. ఊపితే ఊగుతాయి. పీకితే రావు.	చేతి వేళ్లు
telugupatham_blogspot_114	హస్త  ఆరు పాళ్లు.. చిత్త మూడు పాళ్లు	వర్షం
telugupatham_blogspot_115	హరీ అనే లోపు ఒక్కసారే విచారం పాడుతుంది?	హంసపాదు
telugupatham_blogspot_116	హరీ అనకుండానే చచ్చేది?	చెట్టు
telugupatham_blogspot_117	హంస ముక్కుకి ముత్యం కట్టుకొని తోకతో నీరు తాగుతుంది?	ప్రమిద
telugupatham_blogspot_118	హనుమంతుడి భార్య గొప్ప ధనవంతురాలు. తట్టెడు సొమ్ములు పెట్టుకొని తలవంచుతుంది?	కొర్ర కంకి
telugupatham_blogspot_119	సన్న జాజుల కంటే చక్కని పూలు. సన్నని తీగలకు జల్లుగా పూయును?	కాకరపూలు
telugupatham_blogspot_120	సూదికెళ్లి చుక్కల్ని తాకింది	తారాజువ్వ
telugupatham_blogspot_121	శంఖు.. శంఖులో తీర్థం.. తీర్థంలో మొగ్గ	టెంకాయ
telugupatham_blogspot_122	శివరాత్రికి శివ శివా అని పోయేది?	చలి
telugupatham_blogspot_123	శివరాత్రికి జీడి కాయ.. ఉగాదికి ఊరగాయ  ఏమిటదీ?	మామిడి పిందె.
telugupatham_blogspot_124	శివరాత్రికి చంకలెత్తనీయదు.. ఏమిటదీ?	చలి
telugupatham_blogspot_125	శిబి, కర్ణులార్జించిన చెలువ ఏదీ.	కీర్తి
telugupatham_blogspot_126	శిత్తిలో  ఇద్దరు దొంగలు	వేరు శనక్కాయ,  ఆముదం కాయ
telugupatham_blogspot_127	శాస్ర్తం చెప్పన్నా.. నేల గీరన్నా..	పార
telugupatham_blogspot_128	శ్రీ విష్ణువుని మోయుచూ జలగెడు పక్షి?	గరుడ పక్షి
telugupatham_blogspot_129	శ్రీరాముని ఇంటి వెనుక వనం చెట్టు కాచును. పూచును. వాసన లేదు.	చింత కాయ.
telugupatham_blogspot_130	వంకలు జాచి జింకలు బెదురు.	జొళ్లు
telugupatham_blogspot_131	వంక వంకల గడ్డి  ఎంత కోసిన గుప్పెడు కాదు	ముళ్ల కంచి
telugupatham_blogspot_132	అమ్మ తమ్ముడినికాను, కానీ నేను మీకు మేనమామ ?	చందమామ
telugupatham_blogspot_133	అరటిపండుకి పడే విత్తులు ?	బొగడ గొట్టం
telugupatham_blogspot_134	అరచేతికింద అరిసి ?	పిడక
telugupatham_blogspot_135	అడవిలో ఆంబోతు రంకె వేస్తుంది ?	గొడ్డలి
telugupatham_blogspot_136	అలాము కొండకు సలాము కొట్టు	గొడ్డలి
telugupatham_blogspot_137	అంక పొంకలు లేనిది ?	శివలింగం
telugupatham_blogspot_138	అరచేతిలో 60 నక్షత్రాలు ?	జల్లెడ
telugupatham_blogspot_139	అరచేతి పట్నాన 60 వాకిళ్ళు ?	అద్దం
telugupatham_blogspot_140	అంకటి బంకటి కూడా, తిన్న తియ్యగున్నది ఇంత పెట్టు?	మీగడ
telugupatham_blogspot_141	అడ్డగోడ మీద గిద్ద పూజారప్పు	తేలు
telugupatham_blogspot_142	అడవిలో పుట్టింది, అడవిలో పెరిగింది. మా ఇంటికొచ్చింది తైతక్కలాడింది ?	కవ్వం
telugupatham_blogspot_143	అదిలేకపోతే ఎవ్వరూ ఏమీ తినరు. ఏమిటి ?	ఆకలి
telugupatham_blogspot_144	అనగనగా ఓ అప్సరస ఆమె పేరులో మధ్య అక్షరం తీసేస్తే మేక?	మేనక
telugupatham_blogspot_145	అవ్వ చీరకు పుట్టెడు చిల్లులు.	పుట్ట
telugupatham_blogspot_146	ఆకాశంలో 60 గదులు, గదిగదికోసిపాయి, సిపాయికో తుపాకి ?	తేనెపట్టు
telugupatham_blogspot_147	ఆకాశాన అంగవస్త్రాలు ఆరవేశారు ?	అరిటాకు
telugupatham_blogspot_148	అందం కాని అందం?	పరమానందం, బ్రహ్మానందం.
telugupatham_blogspot_149	ఆ కొండకు ఈ కొండకు ఇనుప సంకెళ్ళు?	చీమలబారు
telugupatham_blogspot_150	ఆకాశాన అప్పన్న.. నేల కుప్పన్న , బోడినాగన్న పిండి పిసకన్న	వెలగపండు
telugupatham_blogspot_151	ఆకాశాన కొడవళ్ళు వ్రేలాడుతున్నాయి ?	చింతకాయలు
telugupatham_blogspot_152	ఆకాశాన పటము క్రిందతోక ?	గాలిపటం
telugupatham_blogspot_153	ఆకాశంలో ఎగురుతుంది సక్షికాదు మనుషుల్ని రేసుపోతుంది గాలికాదు ?	విమానం
telugupatham_blogspot_154	ఆకాశంలో పాములు ?	పొట్లకాయ
telugupatham_blogspot_155	ఆకు మర్రిఆకు - కాయ మామిడికాయ పువ్వు మల్లె నవ్వు ? ఆకులేని అడవిలో జీవంలేని జంతువు జీవమున్న	దువ్వెన
telugupatham_blogspot_156	ఆకులేయగు నీరుత్రాగదు నేలని ప్రాకదు. ఏమిటా తీగ?	కరెంట్
telugupatham_blogspot_157	ఆడ వాళ్లు కు ఉండనిది.. మగవారికి ఉండేది?	మీసం
telugupatham_blogspot_158	ఆ ఇంటికి ఈ ఇంటికి లాలా బుడిగి ?	కుక్కపిల్ల
telugupatham_blogspot_159	ఇక్కడ విడిచిన కోడి ఇందూరు పోయె ?	లేఖ
telugupatham_blogspot_160	ఇటుకతో యిల్లు కట్టి.. దంతాన తనునుపెట్టి.. తాను బోయి (రాజు) సరసమాడెను ?	మొగలిపువ్వు
telugupatham_blogspot_161	ఇంటికి అందం?	గడప
telugupatham_blogspot_162	ఇంటింటికి ఒక నల్లోడు?	మసిగుడ్డ
telugupatham_blogspot_163	ఇంటికి లంత ముండ కావాలి ?	భీగము
telugupatham_blogspot_164	ఇల్లల్లా ఎలుక బొక్కలు ?	జల్లెడ
telugupatham_blogspot_165	ఇల్లంతా తిరిగి మూల కూర్చుంది?	చీపురు కట్ట
telugupatham_blogspot_166	ఇంటి వెంక యింగువ చెట్టు ఎంత కోసినా గుప్పుడు రాదు ?	పొగ
telugupatham_blogspot_167	ఇంతింతాకు, బ్రహ్మంతాకు, విరిస్తే ఫెళఫెళ ?	అప్పడం
telugupatham_blogspot_168	ఈ ఇంటికి ఆ ఇంటికి మధ్య దూలం?	ముక్కు
telugupatham_blogspot_169	ఈత చెట్టుకి ఇద్దరు బిడ్డలు?	కల్లు కుండలు
telugupatham_blogspot_170	ఈకల ఈరమ్మ ముళ్ళ పేరమ్మ సంతకు వెళితే అంతా కొనేవారే?	ఉల్లిపాయ
telugupatham_blogspot_171	ఈరు మాను పోయి ఇల్లెక్కె?	చొప్పదంటు
telugupatham_blogspot_172	ఈరు మాను పోయి ఇల్లెక్కే?	చొప్పదంటు
telugupatham_blogspot_173	ఈరు బావి మీద ఇల్లెక్కి చదలు పోయి చెన్న పట్నం చేరి?	చదలు, జాబు
uni5_riddles_ans_1	దాస్తే  పిడికిలిలో దాగుతుంది, తీస్తే ఇల్లంతా జారుతుంది.	దీపం
uni5_riddles_ans_2	ఆకాశంలో ఎగురుతుంది పక్షికాదు. మనుషుల్నిఎగరవేసుకు పోతుంది గాలికాదు.	విమానం
uni5_riddles_ans_3	అందరికి ఒకే కొడుకు ఒకే కూతురు	పెళ్ళికొడుకు, పెళ్ళికూతురు
uni5_riddles_ans_4	కాళ్ళు లేవు నడుస్తుంది, కళ్ళు లేవు ఏడుస్తుంది?	మేఘం
uni5_riddles_ans_5	పైనో పలక కిందో పలక, పలకల మధ్య మెలికల పాము	నాలుక
uni5_riddles_ans_6	పొట్టలో వేలు నెత్తి మీద రాయి	ఉంగరం
uni5_riddles_ans_7	ఎంత మంది నైనాఎంత సేపైనా ఎత్తుకో కలుగుతుంది.	భూమి
uni5_riddles_ans_8	గుడిలో ఉన్నదేవుడిని చూడటానికి తీయాలి రెండు ద్వార తలుపులు మరి మదిలో ఉన్నదేవుడిని చూడటానికి తీయవలసిన రెండుతలుపులు?	నేను, నాది
uni5_riddles_ans_9	ఈ రెండు కారములు అఙానముకు మూల కారణములు	అహంకారము, మమకారము
uni5_riddles_ans_10	మనిషిని మనీషిగా చేయగల ఆయుధం	జ్ఞానము
uni5_riddles_ans_11	కాళ్ళులేవు కానీ అన్నిఊర్లు తిరుగుతుంది కళ్ళు లేవు కానీ అన్నింటిని చూడకలుగుతుంది	మనస్సు
uni5_riddles_ans_12	ఒక రాజు మరియు తన బంటు సమానముగా అనుభవించే సుఖం	నిద్ర
uni5_riddles_ans_13	మతికి గతి లేకుండా చేయునది	ధ్యానము
uni5_riddles_ans_14	వుప్పు తెచ్చే ముప్పు	బి.పి
uni5_riddles_ans_15	నోరు లేదు కానీ సత్యాచరణకు దారి చూపిస్తుంది	సంస్క్రుతభాష
uni5_riddles_ans_16	తండ్రి గరగర తల్లి పీచు పీచు బిడ్డలు రత్నమాణిక్యాలు, మనమలు బొమ్మరాళ్ళు	పనస పండు
uni5_riddles_ans_17	అడవిలో పుట్టింది అడవిలో పెరిగింది మా ఇంటికి వచ్చింది తైతక్కలాడింది.	మజ్జిగ కవ్వము
uni5_riddles_ans_18	ముగ్గురు అక్కచెల్లెల్లు, ఒకరికొకరు తాకలేరు	ఫ్యాను
uni5_riddles_ans_19	చాప చుట్టలేము మడత విప్పలేము	ఆకాశము
uni5_riddles_ans_20	చింపురు చింపురు గుడ్డలు, ముత్యాలాంటి బిడ్డలు	మొక్కజొన్నకంకి
uni5_riddles_ans_21	అడ్డంగా కోస్తే చక్రం నిలువుగా కోస్తే శంకం	ఎర్రగడ్డ
uni5_riddles_ans_22	గునముచే గుర్తించతగినది, కులముచే గుర్తించ తగనిది	వ్యక్తిత్వము
uni5_riddles_ans_23	రాగము సంగీతానికి అయితే విరాగము ఎవరికి?	సాధకుడికి
uni5_riddles_ans_24	ఈ కాయ మన జీవితమును చిందర వందర చేస్తుంది	తలకాయ
uni5_riddles_ans_25	బయట వుండేది బొమ్మ మరి అంతటా వుండేది	అమ్మవారు
uni5_riddles_ans_26	ఇక్కడ నుండి శబ్ధము వస్తుంది.	నిశ్శబ్ధమునుండి
uni5_riddles_ans_27	విగ్రహానికి కాదు ఇది నిగ్రహానికి మాత్రమే	సుప్రభాతము
uni5_riddles_ans_28	మాత్రు గర్భములోమరియు సముద్రములో కదలికలు పెంచేవాడు	చంద్రుడు
uni5_riddles_ans_29	వుంటే శ్వాసపైన ఉంటుంది లేదా ఆశపైన ఉంటుంది.	ధ్యానములో మనస్సు
